--------------------------------------------------------------------------------------------------------------------------------------------------------------------------------------------------------
--------------------------------------------------------------------------------------------------------------------------------------------------------------------------------------------------------
--------------------------------------------------------------------------------------------------------------------------------------------------------------------------------------------------------
--------------------------------------------------------------------------------------------------------------------------------------------------------------------------------------------------------
--------------------------------------------------------------------------------------------------------------------------------------------------------------------------------------------------------
--------------------------------------------------------------------------------------------------------------------------------------------------------------------------------------------------------
--------------------------------------------------------------------------------------------------------------------------------------------------------------------------------------------------------
-------------------------------------------------------------------------------------------------------------------------------------------------------------------------------------------------------v
-------------------------------------------------------------------------------------------------------------------------------------------------------------------------------------------------------f
-------------------------------------------------------------------------------------------------------------------------------------------------------------------------------------------------------f
-------------------------------------------------------------------------------------------------------------------------------------------------------------------------------------------------------f
-------------------------------------------------------------------------------------------------------------------------------------------------------------------------------------------------------f
-------------------------------------------------------------------------------------------------------------------------------------------------------------------------------------------------------f
-------------------------------------------------------------------------------------------------------------------------------------------------------------------------------------------------------f
m--X---X---------X-X-----------X--X--X---------------------X-------X-------X-----------XX---X---------------------------X--------------X---------------------------------------------------------------X
XX--XXX-XX-XXX-X--X-XXXXXXXX-X--XX-XX-X-XXXXXXXXXXXXX--XXXX-XXXXXXX-XXXXXXX-XXXX-XXX-XX--XX--XXXXXXXXXXXXXXXXXXXXXXXXXXX-X-XXXXXXXXXXXX--XXXXXXXXXXXXXXXXXXXXXXXX-XXXXXX-XXXXXXXXXXXXX-XXXXXXX-XXXXXXXXX
