--------------------------------------------------------------------------------------------------------------------------------------------------------------------------------------------------------
---------------------------------------------------------------B---------------------------------------------------------------------------------------------X------------------------------------------
---------------------------------------------------------------B----------------------------------------------------------------------------------------------------------------------------------------
----------------------------------------------------------------------------------------------------------------------------------------------------M---------------------------------------------------
--------------------------------------------------------------------------------------------------------------------------------------------------------------------------------------------------------
------------------------------o-------------------------------------------------------------------------------------------------------------------------------------------------------------------------
------------------o-------------------------------------------------------------------------------------------------------------------------------------------------o-----------------------------------
---o-------------------------------------------------------------------------------------------------------------------------------------------B-------------------------------------------------------v
------------------------X------------------------------------------------------------------------------------------------------------------------------------------------------------------------------f
-------------------------------------------------------------------------------------------------------------------------------------------------------------------------------------------------------f
----------------------------------------------------------------------------------------------------------------------------------------------o--------------------------------------------------------f
----B------------------------B-------------------------------------------------------------------------------------------------------------------------------------------------------------------------f
-----------------------------------------------------------------------------------------------------------------------------------------------------------------------o---------B---------------------f
-------------------------------M-----------------------------------------------------------------------------------------------------------------------------------------------------------------------f
m------------------------------------------------------------------------B-----------------------------------------------------------------------------------------------------------------------------X
XXXXXXXXXXXXXXXXXXXXXXXXXXXXXXXXXXXXXXXXXXXXXXXXXXXXXXXXXXXXXXXXXXXXXXXXXXXXXXXXXXXXXXXXXXXXXXXXXXXXXXXXXXXXXXXXXXXXXXXXXXXXXXXXXXXXXXXXXXXXXXXXXXXXXXXXXXXXXXXXXXXXXXXXXXXXXXXXXXXXXXXXXXXXXXXXXXXXXXXX
