--------------------------------------------------------------------------------------------------------------------------------------------------------------------------------------------------------
--------------------------------------------------------------------------------------------------------------------------------------------------------------------------------------------------------
--------------------------------------------------------------------------------------------------------------------------------------------------------------------------------------------------------
--------------------------------------------------------------------------------------------------------------------------------------------------------------------------------------------------------
--------------------------------------------------------------------------------------------------------------------------------------------------------------------------------------------------------
--------------------------------------------------------------------------------------------------------------------------------------------------------------------------------------------------------
--------------------------------------------------------------------------------------------------------------------------------------------------------------------------------------------------------
-------------------------------------------------------------------------------------------------------------------------------------------------------------------------------------------------------v
-------------------------------------------------------------------------------------------------------------------------------------------------------------------------------------------------------f
-------------------------------------------------------------------------------------------------------------------------------------------------------------------------------------------------------f
-------------------------------------------------------------------------------------------------------------------------------------------------------------------------------------------------------f
-------------------------------------------------------------------------------------------------------------------------------------------------------------------------------------------------------f
-------------------------------------------------------------------------------------------------------------------------------------------------------------------------------------------------------f
-------------------------------------------------------------------------------------------------------------------------------------------------------------------------------------------------------f
m--X---X---------X-XX----------X--X--X---------------------X-------X------XX-----------X-----X----------X------------X--------------------------------X-------------------------------X--------------X-X
XX--XXX-XX-XXXXX--X--XXX-XXX-X--XX-XX-X-XXXXXXXXXXX-X-XXXXX-XXXXXXX-XXXXXX--XXXX-XXX-XX-X-XXX-XXXXXXXXXX-XX-XXX-XXXXX-X-XXXXX-XXXXXXXX-XXXX-XXXXXXXXXX-XXXXXXXXXXXXXX-XXXXXXXXXXXXXXXX--XXX-XXXXX-X-X-XX
