--XXoXoE-E-oo?-X--BE---EM-|---XM-B-ME-??M-B-T-|--X-B-ME-?--MTTT?BT-B----B-M|-X--X-X-B-X?--B--X?-T-o|X--EoE--B|M?o--EE-MM--o|T--|o-B|-X-oXXTE---E?|EE-|-B||-oBM-oo--?BoB--XEB|-oXo-B?oEM|?o--o--EM-?Too-|
M--E|Xo?-X--MBMT--Xo--X-Moo---BE---T|-oXBET-|oB--o-o-X-----TB-T|o|-E----|-EM-?--M-X-o-TM----TB|-E-EBo--To|--X?oBMX-|T-B---TMT--?E-Xo-E-T-MBo----TE---o-----TEE-Mo---B|o--oBMM-MXE--?TMXo-M--o-B||EM|-X--
T-M-T?Mo-M-To?EE---E--E-BoX----o-E-XE-MM|Xo--M---?-M-TX-T--XE?Mo|M-T----?-M|-E--|-B-?-T?--|-EEB-T-Too--BMX--|-MooE-|E-M?--|X----E-Eo---E|-BM---o-XEM-B-|Eo-oMo-|?--?-E|--oo|B-XET-EBTM?XET--|-oX?M|?XB-X
X-XMEoXB-|-XX--T--M---|?-X----o--X-EE-|ET-o-XBM--E-M-EB-|--?ToTMEo------E-?M-T--o-?-M-ET--E-|oB-T-?-|--o|X--B?ETMM-E?-oo--B|---?M-XE-o-M-MXX---T?BBX-M-XBT-?MB-MT---TT?--?MB--?o--XT|MXX?E--E-BTTMTM|?-?
E-??o|??-B-oMETE--T---T?M?|---X----BE-XXEo--|TM----|-|B-T--EE?MXME-?----M-BX-?--X-X-?-BX--T-XEo-E-BBB--BTM--Bo?oE?-|--M?--|?M--B---?-E-?T|MB---BMTX----TME-ooE-?E----oo--M?TM-??|-ETEXXEBX--E--oT?-?E?-?
|-XoTo|--T--EMTM--XX--MBTEE---oo-?-??-TToB?-XT|--M-X-T?-?--M?|B-|?-T----M--M-M--B-B-?-T|--M-|E?-M-MB---EMB---BB?TE-M?-XM--T-|--XT-E?-M-B-XEE---|M?EE-E-ETM--|M-|X--BE-|--EE|X--Xo-M-EMB?BM--|-|?ToToMo--
o-EMEET?-M-E-oBT---E--B-?|T---BE-|-oT-Mo?Xo-TXB--X-?-X--E--B-B?E?-------X-XM-o--o-B-E-BX--X-EBT-E--XT--oEM--X-?-|X-|X-?E--T|T--E?-oE---EMXXE---XoooT-E-B|o---E-EE--ToBM--|E|T--?X-?ME-EMB?--E-M-XEE-EE-|
E-||XX|B-X--BXMB---B--M|-T?---|--|-MM-XTB?|-?oE--B-T--?-E----|B???-?----T-TB-o--E-M-B-?o--?-|BT---XEM--XXX--|?MBBo--T-|E--XoX--BM-oB-o----EE---M?TBM---o|o-?oE-?X--EXBB--?oTM-MB--M?|?BBMT--?-MM|?MB|o-v
--?MT||M-?-E-TMT--EX--oM?E?----o-E-M|-XMT-o-|EX--X-E-o--M---XBXo-X-X----M-o?-X--?-o-?-o---X-ETE-X-M??--?To--M-EE?T-X--B?--MTB--?|--X-M-B?E-E---oXoo|-M-?MT-B?M-X?--?|EE---X?E-EoT--EE-BBEM--|-EET-X--|-o
?-XTToX--X-TMMoE---X--?XEBE---??-X-EX-T?oMM-TM?--X-?-X|-T--M?-|Eo|-o------TT----o-o-M-??--X-BTE-M--MB--?|E--oEBT|T--B-?o---?E--BX-T?-M-|T-Mo----|MBM-T-X|--B?B-||--M|B|--EE-T-oE?-?T-B||-?--?-oE-XBTT|-?
--TBET||-T-MXEE---?|--oBE-E---|E-T-|o-Moo-M-M?B--?-?-B--B--MXBBXMB-T----o-MM-o--B-|-T-TE--?-BTX-M-?M|--oMB--MXooE?-o--EE--?TM--E--oM-T-XBoEo---XMEB--E-?To-EXM-ME--MEoE--XXT--BX|-BTMX?B|?--?-BXoMMMoE--
T-|M|MBX-X-oEBME--oX--ME|??---EX-M-TB-?XBBo-o|T--?-o-MT-|--|BB?-MB-|------?X-X--X-|-o-TT----|MM-X-?TB--E||--T??o?B-BT-|M--oT?--?M-T|-|--MXBT---??||B-T-|X|-MXM-oE--T|oT--?-M|-XME-M|M?o||-----|XE?oEMT-T
E-E?-BET-E-MX--o--B?--EETMB---?B-?-Xo-EX-T|-oT-------MX-X--B?|BE|E-X----?--B-X----T-M-BE--|-TE|-o--Bo--XEB--TME?-o-B|-BX--?E|---|-|M-M-|o-ET---T-?|?-X-BEM-B?o--T--MBBM---||X-E?T-XoT-BTTo--M-ETXToM|o-M
B-|EETE|-?--TE|X--MX--EXTMo---E--X-E|-?XX?E-Mo?--?-X-oB-?--|EMTMTE------X-M?-|--|-?---?T--B-EoB-E-TXB--M?|--ToXToo-?|-X|--ETB--E?-M|-X--E|ME---TM|X|---??E-XB?-M---oTEo--|MMB-TBX-??TX?T-?--|-EE|BTBoE-|
m-TBoB-B-X-MoXBo--X---X-TXT---TE-?-EE-oXE---E-M--X-T-||-B--BBBMEM--M----B-XM-T--|-T-X-|?--B-oMB-M-EET--XTB--EM?-ME-E--E|--M-?--|?-BX-E-B|-|T---TE?EB-o-?T--XX--o?--?oTo--oMXT--?T-?X-?|T?B--o-TEBTXoEo-|
XXXXXXXXXXXXXXXXXXXXXXXXXXXXXXXXXXXXXXXXXXXXXXXXXXXXXXXXXXXXXXXXXXXXXXXXXXXXXXXXXXXXXXXXXXXXXXXXXXXXXXXXXXXXXXXXXXXXXXXXXXXXXXXXXXXXXXXXXXXXXXXXXXXXXXXXXXXXXXXXXXXXXXXXXXXXXXXXXXXXXXXXXXXXXXXXXXXXXXXX
