----E--------------------M---------E-----------------------?--------------------------------M--------------------------MMo---E------M----B-------------M------------E------------------------o------ME-E
|-----------o------M----------------MB--o-----E--X-------------------------X-E--?---E----B----------------------B---------------M-M----MX--------------------------------------B-------------EE--X----EB
B-o-----------------oB------B-------------X---------------?-----------------o--------M---------------------------B-----------------------X--------M-E?------------------------------------------------MX
T-o------------------------------------M------MM-----------X-B---o--------o--E------oM--------------EM--------oM--------X-----X--------------------------------------X-E----------------------------M-TB
E----E----------B----------B------------------E--------------o------oE-----------------------------X----------E----B-----------------------------------------XX---?-----X---------Eo------M-oE-X---o--XX
oo-----E------------B-?-----B------E----------------------M--------------------------?-----------------------X------------------------------?-?----------------Xo--------------?-B-B------------------XE
X?-----B----------X--------------?o------X------------------X-------?-----B--------------E-----------------X----------------------E-------o-o----?-------------------?---------X-------?------?--------|
M---------------B-------E------------------------E-M---------------EX---B-X-------M--E--------------B---------o----E--X---M--------X--------o-XB------E----------------B------------------?--X-E------?v
?-------------B---E-------------------X---------------o--------o----------------------------------M-----X---E--X-----------------------X-------------------?------?-------E--------X------------------BT
o----?-----E---------?----------------------EE---------------------------?------E?-----X--E?-----------------------o--------o?--E-----------X-----------------------------------------B---o-----------TX
B-----M----------------X------------B----------------------------X----------------------E----------------------M------------o-------------------------B-X--------E-----------------M-----E-----------ME?
?X--?----?----M-----B------------M-----------------E---------------------------B----E----B-----B----------o------?-?----------X----------------------------------B--E--?------X-----------------------oo
M----------X--------E---------------------------------o--------------B--------X--E-----M--------B-B-------------B---------------------------------------?-------o-E--------------oEE---?-o-----E-BB--T-X
o---------------X------------------------------o-----------------o----?---------------B-----B-------E-----M---------M---------M-----------X-o-------------------o-------E---------X--M----------------BX
mX---------XMo-------------o---------XE---X-M-B--X-------------X------X--B---------X--?--------X-----X---EM-------XX-----------o-X--X---X----------E---B------X---X-X------------------o-----------B-X|o
X-XXXXXXXXX-XXXXXXXXXXXXXXXXXXXXXXXXX-XXXX-XXXXXX-X-XXXXXXXXXXX-XXXX-X-XXXXXXXXXXXX-XXX-XX-X-XXMXX-XX-XXXXXX-XXXXX-XXXXXXXXXXXXXX-XX-XXX-XXXXXXXXXXXXXXXXXXXXX-XXX-X?XXX-XXXXXXXXXXXXXXXXXXX-XXXXXXXX-XX
