------------------------------------------------------------------------------------------------------------------------------------------------------------------------------------------------?EXXM-T-
------------------------------------------------------------------------------------------------------------------------------------------------------------------------------------------------MBE-|TE-
------------------------------------------------------------------------------------------------------------------------------------------------------------------------------------------------BX-EoTT-
------------------------------------------------------------------------------------------------------------------------------------------------------------------------------------------------B?-E???-
-----------------------------------------------------------------------------------------------------------------------------------------------------------------------------------------------E-M-|ME|-
------------------------------------------------------------------------------------------------------------------------------------------------------------------------------------------------ooEXE-M-
------------------------------------------------------------------------------------------------------------------------------------------------------------------------------------------------???oMoT-
------------------------------------------------------------------------------------------------------------------------------------------------------------------------------------------------TE-|||ov
------------------------------------------------------------------------------------------------------------------------------------------------------------------------------------------------BT-|BBXf
------------------------------------------------------------------------------------------------------------------------------------------------------------------------------------------------?oB?|E-f
------------------------------------------------------------------------------------------------------------------------------------------------------------------------------------------------?EBTM??f
------------------------------------------------------------------------------------------------------------------------------------------------------------------------------------------------X--X-Eof
------------------------------------------------------------------------------------------------------------------------------------------------------------------------------------------------T?o|o|-f
-------------------------------------------------------------------------------------------------------------------------------------------------------------------------------------------------MM?ToEf
m--------------------------------------------------------------------------------------------------------------------------------------------------------------------X--------------------------|XB-oM-X
XXXXXXXXXXXXXXXXXXXXXXXXX-XXXXXXXXXXXXXXXXXXXXXXXXXXXXXXXXXXXXXXXXXXXXXXXXXXXXXXXXXXXXXXXXXXXXXXXXXXXXXXXXXXXXXXXXXXXXXXXX-XXXXXXXXXXXXXXXXXXXXXXXXXXXXXXXXXXXXXXXXXX-XXXXXXXXXXXXXXXXXXXXXXXXXXXXXXXXXX
