----------------------------?????-------------------------------------------------------------------------------------------------------------------------------o---------------------------------------
--------------------------------------------------------------------------------------------------------------------------------------------------------------------------------------------------------
--------------------------------------------------------------o-----------------------------------------------------------------------------------------------------------------------------------------
---------------------------------------XXXXXX-----------------------B-----------------------------------------------------------------------------------------------------------------------------------
-----------------------------------------------------------------------------B--------------------------------------------------------------------------------------------------------------------------
--------------------------------------------------------------------------------------------------------------------------------------------------------------------------------------------------------
---------------------------------------------------------M----------------------------------------------------------------------------------------------------------------------------------------------
---------------------------------------------------------------------------X---------------------------------------------------------------------------------------------------------------------------v
--------------------------------------------------------------------------XX---------------------------------------------------------------------------------------------------------------------------f
-------------------------------------------------------------------------XXX-----------------------------------------------------------------------------------------------------------B---------------f
------------------------------------------------------------------------XXXX---------------------------------------????--------------------------------------------------------------------------------f
-----------------------------------------------------------------------XXXXX---------------------------------------------------------------------------------------------------------------------------f
----------------------------------------------------------------------XXXXXX---------------------------------------------X-----------------------------------------------------------------------------f
----------------X------------------------------------B---------------XXXXXXX-----------------------------------------X--XX---------------------------------------------------------------T-------------f
mE-------------XX---E-----------------------------------------E-----XXXXXXXX-----------------------------------------XXXXX------------------E--------------------------------------------|-------------X
XX----XXXXXXXXXXX-XXXXXMXXXXXXXXXXXXXXXXXXXXXXXXXX-----XXXXXXXXXXXXXXXXXXXXXXXXXXXXXXXXXXXXXXX--XXXXXXXXXXXXXXXXXXXXXXXXXXX----XXXXXXXXXXXXXXX????XXXXXXXXXXXXXXXXXXXXXXXXXXXXXXXXXXoXXX-|---XXXXXX-XXXX
