EB|-o-M-E|oETToEoo-------------------------------------------------------------------------------------------------------------------------------------------------------------------------------------E
o|EB|M-XTE-XM?ETX--------------------------------------------------------------------------------------------------------------------------------------------------------------------------------------X
-ETXXBE-oo?-o--XEM-------------------------------------------------------------------------------------------------------------------------------------------------------------------------------------E
o|oTXXT?oBM||B??|E-------------------------------------------------------------------------------------------------------------------------------------------------------------------------------------T
o||o|B-||EEBoBo-||-------------------------------------------------------------------------------------------------------------------------------------------------------------------------------------E
|X--ETX|?oM-oM|oMT-------------------------------------------------------------------------------------------------------------------------------------------------------------------------------------|
M?ToX?|XXTM--M|EME-------------------------------------------------------------------------------------------------------------------------------------------------------------------------------------E
o-M?|MME-BM|T|?B?E-------------------------------------------------------------------------------------------------------------------------------------------------------------------------------------v
--o-ETo|-Boo?MEEEX-------------------------------------------------------------------------------------------------------------------------------------------------------------------------------------X
-Bo|B?-TT?B?BM?-MB-------------------------------------------------------------------------------------------------------------------------------------------------------------------------------------E
BMXXooBE?EoX-|-X?--------------------------------------------------------------------------------------------------------------------------------------------------------------------------------------o
?-EMBo?X-E|B?-X-o---------------------------------------------------------------------------------------------------------------------------------------------------------------------------------------
oo|o||EE?T?M|BBETM-------------------------------------------------------------------------------------------------------------------------------------------------------------------------------------E
M-T?X-XB|XBE?BTBXE-------------------------------------------------------------------------------------------------------------------------------------------------------------------------------------T
mM|TMT|EEM|XooTXEE--------------------------------------------------------------------------------------------------------------------------------------------------------------------------------------
XXXXXXXXXXXXXXXXXXXXXXXXXXXXXXXXXXXXXXXXXXXXXXXXXXXXXXXXXXXXXXXXXXXXXXXXXXXXXXXXXXXXXXXXXXXXXXXXXXXXXXXXXXXXXXXXXXXXXXXXXXXXXXXXXXXXXXXXXXXXXXXXXXXXXXXXXXXXXXXXXXXXXXXXXXXXXXXXXXXXXXXXXXXXXXXXXXXXXXXX
