--X-??-E-E--o?-X--EE---MM||---?--B-ME--BB-B-||?E-X-|-M--M--M--ToBX-?----M-M|----o---o--B--B-oX?-M-oB----?----|M?o------M--oMT--|o----X--X--E----?|---|---|-o-M-oo--?B-?--TXB--oX?-BBoE-|-o-----EMEE--o-|
M---B--?-B--MBMT--?o--XBMXo---E----T|--MX-T--BBM-o-|-X--|--T-ET?T|-E----?-EM----T---T--o----XB|-X-?X---MM----?oBM---------TTT--?E----E-----o----TE---o-----T-E-Mo---B-T--X??--MXB--oTM-o-M-----||Eo--X--
T-M--M-o-|--o?EE--ME--E?BMX---o--E-XE--EM-o-XBoE-?-M-T--?--X--MTTE------|-M|----o---B--E--|-?EB-B-Mo----T-----Moo------?--|-----E-------|--M-----X---B---o-o-o-|?--?--B--||E--XEB-E?TM-X-T-----X?BM--B-X
X-X-oE-B-X--X--T--?---|X------B--X-EE--T|-o-M-|E-E-o-E--?--?-MTTo--?----o-?M----B---|--E--E-EoB-E-M?---TT----?ETM------o--B?---?M----o-----X----?B---M---T-?-B-MT---T----MBT--?oB-X?|M-X-E-----TTEB--?-?
E-?-ET-?-T--METE--|---TBMX|---M----BE--oM---BX?M---B-|--M--E-oMoX?-?----o-BX----M---E--o--T--Eo-|--E---M|----o?oE------?--|XM--B-----E--T--B----MT-------E-o-E-?E-----X--M??--??B-EXEX-E-X-----oT?M--?-?
|-X-B?------EMTM--oX--M?ToE---o--?-??--TM-?-|M?M-M-?-T--B--M-XBETT---------M----B---M--B--M-|E?---|M---?T----BB?T------M--TM|--XT----M-----E----M?---E---M---M-|X--BE-X--oM?---X|-MEEM-?-M-----?TT|--o--
o-E-??-?-?---oBT--oE--B-?BT---X--|-oT--XT-o-Eo||-X-|-X--M--B-T?M?|-E----M-XM----?---|--B--X-|BT-?-?E---?------?-|------E--T|T--E?-------M--E----oo---E---o---E-EE--To-o--B??---?B-?-E--M-?------X||--E-|
E-|-To-B-o--BXMB--XB--MX-|?---o--|-MM---E-|-MBMM-B-B----E----EBT?E-B----?-TB----B------o--?-TBT-B-X?---TE----?MBB------E--XoX--BM----o-----E----?T-------o-?-E-?X--EX-B--oM|--MB--M?|?-B-T-----M|XE--o-v
--?-Xo-M-----TMT---X--oT?X?---|--E-M|--TX-o-|BTT-X-|-o--T----BX--o-?----M-o?----B---T--X--X-oTE-B------E------EE?------?--MMB--?|----M--?--E----Xo---M---T-B-M-X?--?|-E--XX---Eo|--?E--B-M-----EToM--|-o
?-X-BB---B--MMoE--EX--?XE-E---?--X-EX--X--M-EEM?-X---X--|--M--|EMo-o----?-TT--------B--T--X-BTE-T-oM----B----EBT|------o---ME--BX----M--T--o----|M---T-----B-B-||--M|-|---|M--oE--??-B-|-?-----E-XE--|-?
--T-|X-|-o--XEE---E|--oEE|E---?--T-|o--TE-M-oET|-?-|-B--B--M-MBBXo-M----|-MM----?---B--X--?-|TX-T-?E---Bo----XooE------E--?BM--E-----T--B--o----ME---E---o-E-M-ME--ME-M---ME--BXM-BMMX-B-?-----Xo??--E--
T-|-E|-X----EBME--|X--MX|o?---E--M-TB---X-o-XMo--?-B-M--|--|-T?M|?-E----B-?X----M---X--M----TMM-T-oM---?M----??o?------M--o|?--?M----|--M--T----?|---T---|-M-M-oE--T|-o--M?|--XM|-M?M?-|-------XEXM--T-T
E-E-M|-T-|--X--o--E?--EMTMB---?--?-Xo--ET-|-oEo|---T-M--E--B-EBBBX-o----B--B----?---o--M--|-ME|-M-BT---oE----ME?-------X--?-|---|----M--o--T-----?---X---M-B-o--T--MB----XM|--E?E-X|T--T-o-----TXTE--o-M
B-|-TM-|-E--TE|X--XX--EBT|o---M--X-E|--oE-E-E-BM-?-X-o--E--|-?TEoo-B----?-M?----X---?--T--B-BoB-M-o|---BX----oXTo------|--ETB--E?----X--E--E----M|-------E-X-?-M---oT-M--|oX--TB?-?|TX-T-?-----E|MX--E-|
m-T-o?-B-E--oXBo--?---X|TTT---E--?-EE--TM---EoTB-X-o-|--E--B-EM-ME-E----?-XM----T------B--B-XMB-o--B----?----M?-M------|--M-?--|?----E--|--T----E?---o-----X---o?--?o-T--oo?---?E-?|-?-T-B-----EB|T--o-|
XXXXXXXXXXXXXXXXXXXXXXXXXXXXXXXXXXXXXXXXXXXXXXXXXXXXXXXXXXXXXXXXXXXXXXXXXXXXXXXXXXXXXXXXXXXXXXXXXXXXXXXXXXXXXXXXXXXXXXXXXXXXXXXXXXXXXXXXXXXXXXXXXXXXXXXXXXXXXXXXXXXXXXXXXXXXXXXXXXXXXXXXXXXXXXXXXXXXXXXX
