------------------------------------------------------------------------------------------------------------------------------------------------------------------------------------------------TT|MooT-
------------------------------------------------------------------------------------------------------------------------------------------------------------------------------------------------E|M|M-T-
------------------------------------------------------------------------------------------------------------------------------------------------------------------------------------------------|XE?oB|-
------------------------------------------------------------------------------------------------------------------------------------------------------------------------------------------------TTEE-TM-
------------------------------------------------------------------------------------------------------------------------------------------------------------------------------------------------?EM||?M-
------------------------------------------------------------------------------------------------------------------------------------------------------------------------------------------------?-?|BMT-
------------------------------------------------------------------------------------------------------------------------------------------------------------------------------------------------o|T-MEE-
------------------------------------------------------------------------------------------------------------------------------------------------------------------------------------------------|X|??-Tv
------------------------------------------------------------------------------------------------------------------------------------------------------------------------------------------------o-M|EMof
------------------------------------------------------------------------------------------------------------------------------------------------------------------------------------------------|ToooTBf
------------------------------------------------------------------------------------------------------------------------------------------------------------------------------------------------BXoB|E-f
-------------------------------------------------------------------------------------------------------------------------------------------------------------------------------------------------oX|-|?f
------------------------------------------------------------------------------------------------------------------------------------------------------------------------------------------------?TEBoBTf
------------------------------------------------------------------------------------------------------------------------------------------------------------------------------------------------TMBEX-?f
m-----------------------------------------------------------------------------------------------------------------------------------------------------------------------------------------------|E|TTEEX
XXXX-X-XXXXXXXXXXXXXXXXXXXXXXXXXXXXXXXXXXXXXXXXXXXXXXXXXXXXXXXXXXXXXXXXXXXXXXXXXXXXXXXXXXXXXXXXXXXXXXXXXXXXXXXXXXXXXXXXXXXXXXXXXXXXXXXXXXXXXXXXXXXXXXXXXXXXXXXXXXXXXXXXXXXXXXXXXXXXXXXXXXXXXXXXXXXXXXXXX
