E?--B-oX-?-BoBME--X-BTBEEBE---X-|X?-E|BM--E-M--M-B-BMo|XB---M-----B-|---MMoM---X-T-B-E-|BM--X--BXEET-----BBMB---?-X?|BM-E----MEB--|-|oBMT-E-TB-X-|--MMEB|-X-?---M---T|||--o-?-?T?|X-B-----E-oT-??-|T|BoE
-?-o|-XB-X--T|?E--X-o??MMBo-B----BB-MX??|-M-B--E-B-|MEoME---|-B---o-----?T-EX--T-?-|-M--||T-T--X||MT-----TMXEE-MX-|o|-XXX-M--M?|--|-?Eo?E-X-Eo-|-M-E?BBMo-o--T-TE|--M-|X--X-|-XBoo?-------B|X|-MB-?oBX|-
---o|-M----T-o-T--|-T?X?T|T-o---?XT-|ToE|-T-T--B-M-?X??XT---?-?---X-X---?MTM---M-|-o-E-?T|o-M--?-XB-------EoB|-X?-TEMoB|o-|--MEE--o-TBooT-|-XX-T-T-ooB|Eo---oE-M?M--oo|M--T-|-TTEMX-E-----o|?|-BX-?EXE-E
?o--E-XM-X--?BTM--M-MTXX|XX-X-B-E|E-|MEXT-|-o--o-E--EX|To---E-E---T-----E?Bo|--?---?---Bo---|--EM|To-----BMXT?-X--?|oT|BT-|--?oE--X-Eo-B|-X-TE-M-|-XM|XET---MT-MTo---BTM--T-B-E|?MM-?-----?E|--oT-EXX?EE
-E-TX-|B---MTE|X--E-MEM?-MM-----?o--BTo|?-T-T-------T?EMM---o-T---?-|---BEBE?--E-|-B-E-EM|--T--oEMEo------X??B-XE-ME|BTBB-E--XEo--B-oMXB?-T-MT-T---|MToBT-o-E?-TEE---XB|--?-X-?EM-T-|-----oXT|-oo-T?|X?T
BM--|-MB-|-BX?-B--T-o?oT?|M-M-?-XXT-?-?oB-|-|--o-o--MTT?T---|-----X-B---MBBTT--B-?-B----XT?-B--E--Eo------Moo|-|o-ToB-oTo-?--|o?--X-B|BM|-M-XX-T-E-||EBTX-M-TM-|Mo---?-T--E-T--EoTB-o-----M?MT-oE-XEXo??
XB-|T-??-o-TXoBB----TooMMT?-|---|Bo-T-?MX-?-E--?-M-Eo|X|M---------o-X---MMMBX--o-o---o-EE?X-B--B|T|------??XEB-M|-M|E||XX-o--EB|--?-?TBM--B-|--X-E-|M-BTM-T-oT-B|E--B?X---E-|-B?XX|-?-----EEEo-BX--BXBT|
|E-B--TT---XT-BB--E-E-E-MM|-?-o-EX|-|oTX--B-|--E-|-EX-Xo----B-B---T-M---|B?MB--?-M-X-|-|B-|-E---EETX-----|TE|?-BM-E-MX-XB-B--EB|--X-MTo-|-o-TM-M-o-o?EMBT-o-TE-oME--MMT---?-M-EB?o--E-----X?-E-Eo-???oEv
TE-X?--X-o-EBEX|--E-?X|XX|B---X-BoT-o?-|B-o-B--T-o-MXEXTE---?-M---M-B---||MEB--X-o-o-T-T?|M----?Mo?T-----EoB-T-E|-XB-B-?|-?--?ET--|-X|TTT-?-XE-B-o-|?E?B|-?-?|--X|--BXXX--o-E-B?ooE-T-----EXM---o-|BEEX?
oM-B|-|T-?-EE?XM--E-oXBEBMo-?-X-M|M-|EX?X-?-|--X-o--XMETM---X-M---|-X---Eo-|---X-B-?-?-oEoE-?--BEM-B-----T-?|--XB-BooXMEM-E--|B-----TET-o-M-o--X-X-EB?-ME---Bo-E|T--EBET--|-|-M|-|T-|-----T?o|-|--oB--?T
oB-EE-EX-?-oX-|X--E-T|--Moo-|-M-M-X-BB||B-E----B-T-E|oET----B-T---o-T---X-|XM--B---B-|--E-o-|--?XTE|-----XXMEo-?B---?E--E-E--E?T--T-B|EEX-X--T-?---oMB?oT-|-EE--MM--B|?|----|-??-T--T------TMo--o--X?--E
-?-??-oT-B-oE-TX--E-ET|oBXT---|-?o?-E?XTo-|-o--T-X-BT--E?---X-|---o-E---XMMBE----M-B----|XM----?ooXT-----oo?oX--|-ME?MM-?-T--MoE--T--BT??-|-oo-M-E-|E-T-M---T?-XXT--T??o--T-o--M-E?--------MEX-??--||ooE
o|-X?-|E-E-o|-E---o-MXE|oB?-T-o-|Bo--METo-M----|-?-oXoTBM---|-----X-|---T|BX---?-|-E-M-MXoB-B--???BE-----E?|oE-?T--E-EMTM-M--TXB--?-oB?BE-B-?M-E-o--EMM-?-o-X--EBB--EB-|--T---MTT|o-|-----XoMT-Xo-o-XM?E
-|-|M-To-M-?oooX--T-XEXEE-|---?--|o-E-XE|---T--T-?-T|-TMM---|-B---?-E---oTB|B--T-B-M-B---TT-X----X|M-----MEBMX-EB-Bo|BEM?-M--o?|----X-?|B-T-Bo-T-o-o|BT?E-X--|-XB?--oX?M------|MM|B-M-----MB-?-Xo--EBBTB
mo-MB--o-B-E--M|--?-MX-XMM|-M-|-?oB-B|X||-M-o--?-M-oTX|oT---B-?---?-?---X-?EB--|-X-B-X-o?||----o?ooE-----X|o?T-Mo---???oB-o--E-X--B-?|XXX---oo-X-o-MXMEBM-|-|B-oo|--BT-X--E---BBEE--E-----XBT?-MB-BM?o?M
XXXXXXXXXXXXXXXXXXXXXXXXXXXXXXXXXXXXXXXXXXXXXXXXXXXXXXXXXXXXXXXXXXXXXXXXXXXXXXXXXXXXXXXXXXXXXXXXXXXXXXXXXXXXXXXXXXXXXXXXXXXXXXXXXXXXXXXXXXXXXXXXXXXXXXXXXXXXXXXXXXXXXXXXXXXXXXXXXXXXXXXXXXXXXXXXXXXXXXXX
