----E--------------------M---------E-----------------------?----------?----------------------M-----------?-------------MMo----------M----B-------------M----------M-E--------------X---------o----E--E-E
|------?B---o---E--M----------------MB--o-----E--X-------------------------X----?---E---------------------------BM--------------M-M-----X-----------------------M----------------o------------E--X----EB
B-o------------M----o------------------E--X--X--------M---?-----------------o--------M-------------E?------------B-----------------------X--------M--?-------E--?----X--------------------------------MX
T-o-------------------------BM---------M------MM-----------X-B------------o--E------oM--------------EM--------oM--------X-----X----------------------------------------E--------------E-------------M?TB
E----E--------E-B----------------------------E--------?------o-E-----o-----------------------------X----------E----B-----------------------------------oB---------------X-------E--o--------o-BX------XX
oo-----E------------B-------B------E----------------------M--------------------------?-----------------------X------------------------------?-?----------------X-------------------B----------?------MXE
X?-----B---------------------B---?o--EX--X------------B-------------------B--------------------------------X----------------------EX------o-o----?-----------------------------------o-?---------------|
M---------------B--------------------------------E-----------------EX---B-X-------M--E--------------B--------------E--X---M--------X--------o-XB------E----------------------------------?-----E------?v
?-------------B---E-----------M----B--?X------X-------o--------o----------------------------------------X---E--X-------------------------------------------?---------M-------------X------------------BT
o----?---------------?----------------------E----------------------------?-oE----------X--E?--------------------------------o?--E-----------X-------B------------------------------------------------T-X
B-----M----------------X------------E------------------------M--------E----------------o--------------BB-------M------------------------------------X-B-X--------E---?------------------------E-------E?
?---?----?----M-----B------------M-----------------E---------------------------B---------B-----B---------XoB-----?-?----------X------o---------------------------B--E--?---X--X--------------------E--oo
M---o--------?------E------------?--------------------o--------------B--------X--E-----M--------B-B-------------B-------------------------------------o-?-------o-E--------------o-E-----o-------BB--T-X
o--------------M--------------?---------E------o-----------------o----?---------------B-----B-------EB--------------M---------M-----------X-o---------------------------E------------------------E----BX
mX---------XMo----------X--o--------XXE---X-M-B--X-------------X---------B---------X--?--------X--------?---------XX-B---------?-X--X---X----------E---B------X-----X------------------o----------E---|o
X-XXXXXXXXX-XXXXXXXXXXXX-XXX-XXXXXXX--XXXX-XXXXXX-X-XXXXXXXXXXX-XXXX-XXXXXXXXXXXXXX-XXXX-XXX-XX-XXXXXXXXXXXX-XXXXX-XXXXXXXXXXX-XX-XX-XXX-XXX-XXXXXXXXXXXXXXXXX-XXXXX?XXX-XXXXXXXXXXXXXXXXXXX-XXX-XXXXXXX
