--EE---X-|TM--TBB-XX||-XTEo-M--|B-|-B-?-X||EEE-|Xoo?MXT-----TXM--To-EXBX--TX---?|M-|--E--XXXTE-E---M--XBX---M---|-?-?X--oE--X--B---T---T----?-M-TBE?M-----B--Eo-B-?-|---|-|----o-oB?-T--B----||-?-X--M?-
-oM---o|--EB--T|--o-MT-M|XM-X-M--B-MB-B---M||E-EE-|-?oX-----MoM--EB-XEE|--BT--oXXX-?--o-?X-TET--?--T--|TX---?-E---T-BT---M--ME-T------XT-|-Mo---|---|-E-X-B--oT-X-oB----X-o--B|-E?MM-?--o-M-BX-E|XT--TT-
-?T-E-T--?-M--M||EE-E|--E-XB---X||XMB-?-M-MoT?-|-|-E-|M-----??---B--T-BT--T---T-TE-?--T-MB-???-M------oX----B|M-o--To---|o?-oB-E---X--Mo-TE|X-?--T-XM-|-?-T--o--X-T-T---o-----B-M||--T--?-|-M-?-|oT--BM-
-|----ME--T---BT--oBoX-E|?TMT-TTEMB?B-T-T-oXo--||-|o?B---M--ooE--TM--XE---B?--?----?--T-T--E-B-|---o--T-E---EEX-M---B|--XT---|-B---|--oo-B-T--o-E-XMB-E-------T-X-?-X---|-T--X--?|X|-X--?-o--?E--MT---X-
-EM---o?-T?T--XoM-MoXo-X-|M?X-o?XX||E-T-M-BMX?--M-M-o?M--B--Eoo--E|-XTT---|T--TT|T-o--?-Mo-EB--|---T--XXM---BTM-T-o-EB--X-X-oX-B---?--o?-oXE--B-oMEXo-----o--oT-M-X-B-----o--MTo?-X|-M--o-E-?o?-?E|--?|-
-TE---oB-T|X---oX-XEX|--ToBET-BB-M|MB-T-?-?-TM|-o--EEX|--M--MX?--EE-T--T--E---?|ME-X--|-M--o?B-X---|--?|B---oXX-?-|-B-----B-T--T------oX-X-o?-T--B-EX---M----?--?-T-----T-?--|B|-BMB-X--|-E-TMM-??|---?-
-EB---B--|M?---|E-o-E?-|-MEX?-|MoX--M-oXT-TEBB-M--TB|E?--|--M----BE-MBMB--Xo--oo||-B--?-M--|BX-|------MoE---M?T-E-B-oT--To---M-E---B--B--EMMM-|-M--EX-|------Xo-T---M-T-X----|-MX-XT-X--T-E-XE-T-?EB-|M-
-TB---?M-EEM--o-M--|T--T-TMTM-?E-MoB?-T---?o-X----?-TT?--X--M-|---E-|BXB--TE--o??M-B--T-?T-M-o-X---T--|-o----TB-T?---?--oTM-XB-E---T--oB-?EMo-E-MTM-?-o-|----?--M---X---E----X-X-E|T-X--o-T-X-B-oT----Ev
--o---E?-oB----To-TE-B-|EBEo---o-o-T--T-o--B?T-M--MX|B?--o--ToX--oB-MEoB--|M--TEXM-X--B-oB-XB?-X---M--?XT---MXM-T-o-?E--?o--XE-o---M--X|-oMEo-E-BM?MB-B---B--MT---B-|---T-X--M-o|EB|-X--M-?-|oT-TEB--M-f
-EX---X|--T---?TXTTMTX--EMXE||T?XM-?--o-?-Eoo---M--o--|--?--M|M---T--E-T--ET--E-||-|--B-?o-?o--|---T--TTo---|T|---B-Bo--|?T-|E-E---M---B-||-T-|-Eoo?--B-M-T--MT-T-B-B---X-X--MBXTM|o----E-B-EoT-oB---TMf
-|T---o--M|X--T?M-X-|M-??Xoo---?o-----M-T-METE-oT-BBoBE--M--?TT--X--MBTX-E-|--M-?X-o--T-oM-E|?-?---E--Eo-----EE---B-TM--ETT-Mo--------X|-BT-M-B--B?M--T-?-o---o-T-E-o---?-M----X?-BE-|--E-?-MXX-T|---||f
-XE---oX--|X--|?M--T??-XMEoEX-o?ME--X-B-|-|-BM--B-X-MoM--|--oEB--|--??TM---X--oX?--?--X-TM--|B-----o--T-B---E|B-M-M-T---XX|--B-B---E-EE-T-TX-TE-oEE---|-E-X--EB-|---E-----o--MX--M?B-T--T-B|-T--|Mo|--Xf
-?o---E|-XM|--B-|---|?-X-X-B--X-X-Bo--B-T-||-?-E--BB|ME--X--BoB--E?-TXXE--BX--BMB|-X--o-EB-TTB-?---X--Xoo----BB-|-B-T|--M|?-MB-X---B--|M-B|XT-?--B?|oTT---?--E?E--BB----X-M--T-?o?E--X-E--T-BET-M-o--TTf
-BT---?T-o-|--MTB-|-E--BT-B|o-oooBMMo-E??-?MB--Xo-M?TEo-EX--?----|E--X?----?--??XX--?---??-?E|-T---?--XTX----?|-E-T-XM--|oE-|?-|---M--XE-ETo--X--?----T-X-M--B?-B-|-E---?-?----X-Mo-E|--B-M-||--EM----Ef
m-o-X-M?-M-E--XXX-||?---M|-T|--?XoMM|-X-|-BM|E-EM-EoMX|--T--||E-XTB-oMB---?---BEEM---XE-Eo-E-E-E------M|E---EE?-E-E-E?--?|--|?--------X--B-o|X--oXX-?-T-o-T--Bo-|-?-B---o-E--|METTB|-o----ET|-o-oMM--X?X
XXXX-XXXXXXXXXX-XXXXXXXXXXXXXXXX-XXXXX-XXXXXXXXXXXXX-XXXX-XXXXXX-X-XXXXXXXX-XXXXXXX-X-XXXXXXXXXXXXXXXXXXXXXX-XXXXXXXXX-XXXXXXXXXXXXXXXXX--XXX-XXXX-XXXXXXXXXXXXXXXXXXXXXXXXXXXXXXXXXXXXXXXXXXXXXXXXXXXXX
