--E?----||T-MXTBBMX-||--TE-oM--MX-??--E-X|?EBE-|EM-?E|T---oMBMoEoTo-EXBX-|TX--B-|--|--B-XE?-TE-E?--M--XBo---M--MM-?-BX---E--XT--TE|T|-?T----?-B?TBM?o---B-B-E-o-B-TM|--X|T|---BoM?o?ET-X-B-XB||-|To--?M-
-oME--o-M-E-X-T?-Xo-MT-M|XMXX-MBXB-EM-|----|-E-EoB|EBMX----XBXB--EB-XEE|-XBT--M-X--?--X-|-o|ET--T--T--|TX--B?-E|M-T-?T--B---M--?B-M-|-oT-|----M||-E-B-E-M-Boo-ToT|MM---oX?o--B-|-XXMM?-ooEM-BX-EBXo--??-
-?T-E-T-E?-?-EME|EE-E|--|EXE---B-|Boo-X-M-Xo|?-|BM-X??M---X?-XM?-B--T-BT--E---BBTX-?--X-BMoB??-M|-----oXE--oB|MEo--T----|B?-oo--|B?X--To-TEMo-E|-E-XB-|---TToX-ooBB-T--|oX----X-TXX-ET-??o|?-??-BoT--|X-
-|-?--M-E--T||BM--o-oX--|-T?T-T-MMMBT-X-T-|XB--|ET|o?o---MEMB-?X-TM--X---|B?--E----?--E---|T-B-|?--o--T-o--oEEXTB---M|--|E---X--oXM||-Bo-B-T--BME-?MT-E-X--TXoTEo-?-X--?|XT--X?oM-E||X-B?-o?X-E-T-M--BT-
-EMX--o--T?BT|X|MBM-Xo-X-|MXX-oBBX-M--E-M--TX?--|EM---M--BBMB?EM--|-XTT---|T---M|--o--o-|-o|B--|T--T--XX?---BTM|M-o-MB--MEX-o|-E|-M?E--?-oXEE-MMoMTXT---o-oEBoT|B-MEB--T--o--M|-oT||-M-To-?B?o?--TE--XT-
-TEX--o-XT|-oo-BXoX-X|---oBBT-BoMM--B----?EM-M|-E?---E|--M-T--oT|EE-T-XT-XE---?BM--X--M-|-|E?-BXT--|--?|?---oXX---|-M---MMB-TM-B-?B-o-EX-X-o?-B?-B|Eo---M---X?-X|--B---MTB?--|E|XTTB-X--|?E|MMM-o-?--BB-
-EBB--B-E|MXEM--EEo-E?-|-ME??-|MTXXEE-XXT-EEBB-MEXT|EB?--|BMEo-?-BE-MBMB-T-X--?T|B-B----||---X-||-----MoM--MM?Too-B-?T--TBo-E---T|?BB-M--EMMM-oEM-BE?-|-|--M|XoBTBX|M-T?XB---|oMBT-ToX--T?EM-E-TT?|B-TM-
-TBE--?-|EEMXoo-MB--T--T-TM-M-?o?-B?B-o---oo-X---E?B-T?--XB?MB|BXBE-|BXB-ETE--BT?--B--M--?BoBo-X---T--|-|----TB|-?--E?---XMMX?-MTEBTT-?B-?EMo---MTM-T-o-E--|B?-?Xo|oX--MEEE--X-X-T|T-X-ooTT|?BB-oTB--o?v
---o--E-XoB|XX--ooT--B-|EBE-----TMo|--o-o-XB|T-MBTMXEX?--oXXBE?-ToB-MEXB-E|M--?TX--X--E--ET?B?-XT--M--?X---EMXMo--o-?E--TT--X---oXXMM--|-oMEo-BoBMBMo-B---BX-MT-ETXM|--|TMX--M|oE|M|-X-TMM?|BoT-ME---?Mf
-EoT--X-B-T|-|-?X|T-TX--EMX?||T|oMo?----?-?o----BX-o-?|--?|TX|-TT-T--EoT-|ET--|?M-||--M-oMMEo--|BE-T--TTT--?|-TB|-B-Eo---MT-|E-BEBMM?--B-|T|T-T-EoX?X--B|-TBMMTM?MT?B--oXXX--M-MXE|oM--BEBBTXoT-|BX--EEf
-|TT--o-oM|EB?ToM-X-|M-??Xo?---XT-B?o-|-T-EEo--o-|B||oE--M--MB---X--MBTX-|E|--T-?--o--B--?Bo|?-?---E--Eo|--?-EEoE-B-oM--TTT-MT--TT?-|--|-BT-M-B--BMM--T-|-oB--o-TBEBo--B?-M--MBTTMMEX|-oET?-oX-X?-o--BXf
-XE---o---|T-M|oMB--??-XMEoBX-oETEoBT-E-|---EM--|-X-|-M--|T|M|-|o|--??TM-E-X---T?--?--|-?X|M|B--|--o--T-|--TE|BM--M-X---Eo|--X-TM-TETEM-T-TXT-|MoEB-?-|---XETEB-?oBoE----|o--ETX?oEBBT-MT|BXMT--XMo|-B-f
-?o|--E--X?X-EBX|B--|?-X-X-o--X?--BMT---T-?|?o-EX|BMXTE--XEB||EBBE?-TXXE--BX--X-B--------|-ETB--?--X--XoE----BBME-B--M--?B?-M--|?||B--?M-B|XT-T?-B||?TT-X-?T-??o|XoM---MXTM--TE??o?-|X-T-?T?TET-XB---Mof
-BTE--?-BoM-B|MBBo|-|E-BoTB-o-ooTBBM--???-MMT?-X-TMMX-o-EX|Mo|oBE|E--X?--T-?--?TX--X?-B-TTTXE|-TB--?--XT?--o-?|MM-T-MM----E-||-TE-BMo--E-ETo|-B||?E-X-T--BM-T-?BE-TEE--E?B?---XXMBM-T|-MBBMTT|--|MB--B?f
m-o|X-M-?M--?oX-E-|-?---M|-T|--?EoMEM-|-|-TM|E-E-|EToX|--T--XoTETTB-oMB--X?---XXE----X--|?TXEE-E------M-|--|EE?X--E-o?--BB-X|o-XBX|-B-o--B-o|--TXXX-B-T-B-TEXBo?-XE-B--|oEE--||EX|-||o-M-|EX|-o--ME--?-X
XXXX-XXXXXXoXXXXXXXXXXXXXXXXXXXXXXXXXXXXXXXXXXXXXXXXXXXXX-XXXXXXXX-XXXXXXXX-XXXXXXX-X-XXXXXXXXXXXXXXXXXXXXX--XXXXXXXXXXXXXX-XXX-XXXXXXXXX-XXXXXX-XXXXXXXXXXXXXXXXXXXXXXXXXXXXXXX-XXXXXXXXXXXXXXXXXXXXXXX
