-----------------------------------------B------------------------------o-------------------------------------------------------------------------------------------------------------------------------
-----------------------------------?------------------------------------------------------------------------------B------------------------------------------------------------------------------B-B----
------------------------------------------------------------------------------------------------------------------------------o--------------o-----------------------------------------X--?-------------
-------------------------o-------o--B-----------------B-------M-----------------------------------------------------------------------------------------------------------------------------------------
--------o----------------X------------------------------------------------------------------------------------------------------------------------------------------------------------------------------
-------------------------------------o------------------------------------------------------------------------------------------------------------------------------------------------------------------
--------------------------------------------------------------------------------------------------------------------------------------------------------------------------------------------------------
-B--------------------------------------------------------B----------------------------------------------------B------------------o--------------------------------------------------------------------v
----------------------------B-------------------------------------------------------------------------------------------------------------B--o-----------------X---------------------------------------f
--------B-----------------------------------------B---------E---------------------------------------------------------?--B-------------------------------o-----------------------------------oB--------f
------------------B-------------------------------------------------------------------------------------B-------------------------------------------------------o-------B-------------o----------------f
-B-----------------------------------------B--------------------------------------------------------------------------B----X---------------------------------------------------------------------------f
--------------B------------o---------o-------------------------X--------------------------------------------------------------------------------------------------------------------------B----B-------f
------------o-----------------------------------------------------------------------------------------------------------------B------------------------------------------------------------------------f
m--------------------------------------------------------------------------------------------------------E--------------------------------X------------------------------------------------------------X
XXXXXXXXXXXXXXXXXXXXXXXXXXXXXXXXXXXXXXXXXXXXXXXXXXXX-XXXXXXXXXXXXXXXXXXXXXXXXXXXXXXXXXXXXXXXXXXXXXXXXXXXXXXXXXXX-XXXXXXXXXXXXXXXXXXXXXXXXX-XXXXXXXXXXXXXXXX-XXXXXXXXXXXXXXXXXXXXXXXXXXXXXXXXXXXXXXXXXXXX
