--------------------------------------------------------------------------------------------------------------------------------------------------------------------------------------------------------
---------------------------------------------------------------B-------------------------------------------------------------------X--------------------------------------------------------------------
---------------------------------------------------------------B----------------------------------------------------------------------------------------------------------------------------------------
----------------------------------------------------------------------------------------------------------------------------------------------------M---------------------------------------------------
--------------------------------------------------o-----------------------------------------------------------------------------------------------------------------------------------------------------
---------------------------------------------------------------------------------------------------------------------------B----------------------------------------------------------------------------
--------------------------------------------------------------------------------------------------------------------------------------------------------------------------------------------------------
------------------------------------------------------------------------B----------------------------------------------------------------------B-------------------------------------------------------v
------------------------X------------------------------------------------------------------------------------------------------------------------------------------------------------------------------f
-------------------------------------------------------------------------------------------------------------------------------------------------------------------------------------------------------f
-------------------------------------------------------------------------------------------------------------------------------------------------o-----------------------------------------------------f
-----------------------------B---------------------------------------------------------------------X----------------------B----------------------------------------------------------------------------f
----------------------------------------------------------------------------------------------------------------------------------------------------------o------------o---------B---------------------f
-------------------------------M-----------------------------------------------------------------------------------------------------------------------------------------------------------------------f
m------------------------------------------------------------------------------------------------------------------------------------------------------------------------------------------------------X
XXXXXXXXXXXXXXXXXXXXXXXXXXXXXXXXXXXXXXXXXXXXXXXXXXXXXXXXXXXXXXXXXXXXXXXXXXXXXXXXXXXXXXXXXXXXXXXXXXXXXXXXXXXXXXXXXXXXXXXXXXXXXXXXXXXXXXXXXXXXXXXXXXXXXXXXXXXXXXXXXXXXXXXXXXXXXXXXXXXXXXXXXXXXXXXXXXXXXXXX
