-o|MXMoX-BBEMBBM?M-oBMM|-?-?-X-T-XXT-EXMMX-EMM?X|-?oM?ooEXXBBB|-oE-MM-X--||-B?BB--MBBXX?-M???---XXM?TM-XT---?E|-?-oX-X?X?-M-MoMooXo|Bo?BEo-TE-E-B|oBo?ooXXT-ooo-oo?T-oXM?M-?ooBM?--o-MXBBMTX-MM|MXoBXM?X
TEB-E-o--o?-?-ooMXB---B--?Mo--XXMX?TT-B-E-EB-?oBM--X-MoEX?oM-|-MB-B-E-?-T?B-M-BoMo-XT-B--MooX-|T-BBE-oMXXoB-X---M-?B-Too?B?o-o-?-?T-o---BMEoEB?-MXoMXMB-BX-?BMXooToM-M---E-X?Bo?Bo?--?X-B|-?-oB-?--?MX-o
ET|?E-?--o?--o-X-MM?Mo?-XMMooM----BT-oBE|MXXo-X-TMB-?B-----BM|--|-oX|--BX-XX?BX-M--|-X|?M-M-EETo-?X-M--MB-X--?MBX--XX?X---B?-----o-MM--?-MB??-MMoMB-MBX-oBB----Bo--o-MEMoBo-oM----XT-XT-EX-B?BE-oo-M-T-o
EMM???-TB-|T?-oT-?-B?X-M--?-?oXE-BMB?o-|o-XMTXToB--X-ooBXMM-EEEEMoMMX|ooTB--BM-o--MT--M-o-XME--X-o-oM-?MBBXoo?B-BX-oo-E|B-o|E-TT-|oo?----M--X-XB--o?X?M-M?EBM-M-XXXT-B-BB-X-MXB?|-o|-MMM---XBBMBoE-X?o?o
oB-oooXBT---EB??-?MMXMooE-M---EX-BoM--T-?oM?-T--?-B|----?B?Bo|---B??MB??M-|XMB?-E--X--?Xo-?BM|-E?-o--?-----MM-o----XBE|---XE-B-|E-BoB||E-BX-T--?T----B|MoXX?--M--?EX-T-MXX?MXB?|oBTX-?B?BT--?-MMXBoB--XE
B?--X?o|B?|oXB-o-B---Xoo|oX?-TM|---XBXTM-MBoX|Xo?---|oT-M?--T-X-MM-M-M--BTM---X?|--MT---?o-BXoE-T-??-??BMEX?E-?????-oooo|?Mo-MXoM--B?TM|B?To-oo|--To-|B-Mo--?MTE-oB?MTB---?B-o---?MB-o?o?M-oXMo---BB?-?B
-|X---T---B-MEM-?TBBM--?--X-E-T|MoM-oTo--M-oo?-M---E-TE-X-TX?-Mo---T----|M-XXXoBB?o-Bo?Boo-M-?-X?BX?-?oBM-BXT?B?M-ToXo??-XXXooX?-|--ToTB-Bo--XX--T?TT-??-M-?-o|--?--M-X|T--|o-MBBoXo-?Mo-?Bo--EB??o-E-?|
?o-M-TMT??B?XM--Mo-X--oB-X?T-TBoo-o-B?To-M-o-|?MXXB|-|X--X--|--o--MM-|oB-M--o-M-o-?---X--o----BM-XB--MoBX--E?BBMMX-X-o-o--o-X-Bo--EM-?Mo--TB-?X-|Xo-oMXoME--X?-X-XEoMoo?|?o-EM-B?XoT---M-BoTT|--X?ET?o-v
|BB-E-T-o--?o|-oB--o??-oM-MXoM-BE-MoXBo-?-M|MXBM-XBXB-?oX|X-MM---M-o?MBT--|oE?M-BooBM-M|MMBMBo?B-XE-X--X-B?---?M--?B-oXM-Mo-??oBT-o-B-M-?X--XBEMB---XX--T-?---B?X-BM?--MX-T|-o---Bo-|EoB---|-?oBXE|oo--X
X-B|BME-XoMX?X--oTXM-X?-o??--o-BTX?-X-MBoME?MMXTX-M-?-XoXX-?o?-M--MM-?-oT|oMMMo-MXX?B-To?B?-B----X??E|MM-?TBX-XMM?-X-M-o?XX?-B-ooX?o-BT--o--X-X-MMXB--oo?--X|?MX-X--o-?X-|T|BXoM-?--|-MBooMX--?X?--o----
???--MX-?oB--o-MX-BX-oM-Xo-M-MoT-oTXBX-M--X--oToo-??--?XXB-o-BMMXX-X-BBToo-X---?X--??|-BX-X-EM-M-o-T|oM---M---o--MBB-TXMMo?-oE-X---B-E-B??EM-?|-oo-BTMo?|o-X--B?X-BoTX-MTo?---o|-|M|-o-X---?X-?BBE-|??-T
T-X---B-o-TEX--BEMX|-o|?-o-EXM|o-?---?M?-o|-BE--MXXXM?---B-|X-X?--B--?|BX|-XX-B-BB-Bo|--BoMMMM-MBTTEoXM-------BXBoMET-X--?-Booo-T-oBX?BoBM?|-ME--?-|--BE-o-|E-?-M?ooBBB?X-????T|EX-Mo?XMBMX-TX--XXo-o--X
--oBTXE?M|-X-?M---B?ooBo-oX-B?--M|MBX--|MB?-TM-o?X--X-X?X-B-B--|?-|M-?--ME-M-oM-BE--T|Eo-M-oo--BMTMXMM-TBB-BX??BoMXoBB||o-BB?--MEooMXXM---|--|?E-?Xoo--X-oXB-BB?-MM--?--|---BXME-?-MM?--X?-|XXoXo?-?T|B-
B-MMBo?M|M-oB--o-B----oBB-E-?XMBooBX?Bo--BT|-?---B?MB?o---X?XX|XToBo-?-BBTo?o?XoMoooXM-??oM-To--?-X-BB-oXB-M?-XM-XB-BToX--?Bo?-TBM?--BEBXMXEoo?--?--o--|---o--M-o-MB-o-||-oXX?T---oB-B-MX?B??o-oX-B--B-X
mXXXXXXXXXXXXXXXXXXXXXXXXXXXXXXXXXXXXXXXXXXXXXXXXXXXXXXXXXXXXXXXXXXXXXXXXXXXXXXXXXXXXXXXXXXXXXXXXXXXXXXXXXXXXXXXXXXXXXXXXXXXXXXXXXXXXXXXXXXXXXXXXXXXXXXXXXXXXXXXXXXXXXXXXXXXXXXXXXXXXXXXXXXXXXXXXXXXXXXB
X------------------------------------------------------------------------------------------------------------------------------------------------------------------------------------------------------X
