--------------------------------------------------------------------------------------------------------------------------------------------------------------------------------------------------------
--------------------------------------------------------------------------------------------------------------------------------------------------------------------------------------------------------
-------------------------------------------------------------------------------------------------------------------------------------B-------------------------------B----------------------------------
--------------------------------------------------------------------------X-------------------------------------------o---------------------------------------------------------------------------------
--------------------------------------------------------------------------------------------------------------------------------------------------------------------------------------------------------
------------------------------------------------------------------------------------------------------B-------------------------------------------------------------------------------------------------
--------------------------------------------------------------------------------------------------------------------------------------Xo----------------------------------------------------------------
-------------------------------------------------------------------------------------------------------------------------------------------------------------------------------------------------------v
------------------B-----------------------------------------------------------------------------------------------------------------------------------B------------------------------------------------f
-------------------------------X----------------------------------------------------------------------------------o------------------------------------------------------------------------------------f
------------------------BBBBB------------------------------------------B---------------------------------X-------------------------------------------------------------o-------------------------------f
-------------------------------X-------------X----------------------------------------------------------XX-------------------------------T-------------------------------------------------------------f
------------------------------XX-----------------------------------------------------------------------XXX---------------BB--------------|-------------------------------------------------------------f
------?----------------------XXX----------------------------------------------------------------------XXXX-------------------------------|-------------------------------------------------------------f
mE----------XXXXXX----------XXXX------E--------------------------------------------------------------XXXXX--------------------E----------|------E------------------------------------------------------X
XXXXXXoXXXX---XXXXXXXXXXXXXXXXXXXXXXXXXXXXXXXXXXXXXX----XXXXXXXX-------XoXXXXXXXXXXXXXXXXXXXXXXXXXXXXXXXXXXXXXXXXXXXXXXXXXXXXXXXXXXXXXXXX|XXXXXXXXXXXXXXXXXXXXXXXXXXXXXXXXXXXXXX-------XXXXXXXXXXXXXXXXX
