E?----oX-?--oBME----B-B--BB---X-|X?-E|-M--E-E--M---BMo|XB---M-----B-|---M-oM---X-T-B----BM--X--BX|TX-----BBM---X?-X?T-M-?----M-M--|-|TBMT-|-TB-X-|--MMTB--X-?---M---o|o|--o-?-o|?|X--|----E-ET-??--||BoE
-?-o--XB-X--T|?E----o-?oBBB-B----BB-MX-?|-M-M--E---|MEoME---|-----o-----?--EX--T-?-|---o||T-T--X|oEM-----TMX-E--X-|oM-XXB-M--M-X--|-?Eo?E-X-Eo-|-M-E?B|M--o-XT-TE|-----X--X-|---oo?--?----B|X|-MB--MBX|-
---o--M------o-T----T-X-E|?-o---?XT-|T-E|-T-?--B---?X??XT---?-----X-X---?TTM---M-|-o----T|o-M--?-MT|------Eo-|--?-TE--B||-|--M-|--o-TXooT-B-XX-T-T-ooBoE----EE-M?M---oMM--T-|-oMEMX--M----o|T|-BX--EXE-E
?o----XM-X--?BTM----M-Xo-XE-X-B-E|E-|M-XT-|-M--o----EX|To---E-----T-----EoBo|--?---?---Xo---|--EMTT------BMX-?-T--?|o-|B--|--?----X-EE-B|-o-TE-M-|-XM|BE----TT-MTo--MBEM--T-B--|?MM--E----?EM--oT--EX?EE
-E-T--|B----TE|X----M-M-EMT-----?o--BT-|?-T-B-------T?EMM---o-----?-|---BMBE?--E-|-B---oM|--T--oEB?X------X?-B-?E-MEB-TB|-E--X-B--B-oEXB?-X-MT-T---|MTXB--o-o?-TEE--MXB|--?-X---M-T--?----oX?|-oo--M|X?T
BM----MB-|--X?-B----o-ooM|X-M-?-XXT-?--oB-|----o----MTT?T---|-----X-B---MMBTT--B-?-B---|XT?-B--E-XBT------Mo-|-oo-ToX-oTM-?--|-|--X-BXBM|-?-XX-T-E-||E|T--M-XM-|Mo---?oT--E-T--MoTB--M----M?XT-oE--TXo??
XB-|--??-o--XoBB----T-o|oTM-|---|Bo-T--MX-?-o--?---Eo|X|M---------o-X---MoMBX--o-o-----EE?X-B--B|oBB-----??X-B-E|-M|?-|XX-o--E-?--?-?XBM--T-|--X-E-|M-?T--T-|T-B|E---?|---E-|-?XXX|-------EEEo-BX--EXBT|
|E-B--TT----T-BB----E-EBXME-?-o-EX|-|o-X--B-?--E---EX-Xo----B-----T-M---|E?MB--?-M-X---|B-|-E---E-|T-----|TE-?-BM-E-M--XM-B--E-|--X-MEo-|---TM-M-o-o?EMB--o-BE-oME--TM----?-M-TT?o---T----X??E-Eo--X?oEv
TE-X---X-o--BEX|----?-|X-|B---X-BoT-o?-|B-o-B--T---MXEXTE---?-----M-B---|?MEB--X-o-o---B?|M----?MMB|-----EoB-T-E|-XBX--?|-?--?-B--|-X|TTT---XE-B-o-|?E|B--?-E|--X|--?XEX--o-E-MXooE--B----EXX---o--|EEX?
oM-B--|T-?--E?XM----o-BMEM|-?-X-M|M-|E-?X-?-E--X----XMETM---X-----|-X---E|-|---X-B-?---MEoE-?--BE|B?-----T-?---?B-Bo?-ME--E--|-|----TTT-o-|-o--X-X-EB?BM----Bo-E|T---BET--|-|-||-|T--|----T?M|-|---o--?T
oB-E--EX-?--X-|X----T--BXo?-|-M-M-X-BB-|B-E-B--B---E|oET----B-----o-T---Xo|XM--B---B----E-o-|--?XT|T-----XXM-o-EB---|---B-E--E-X--T-B?EEX-?--T-?---oMBTo--|-TE--MM--B|X|----|-TE-T---M-----TXo--o--M?--E
-?-?--oT-B--E-TX----E-|MMXT---|-?o?-E?-To-|-M--T---BT--E?---X-----o-E---XTMBE----M-B---E|XM----?oXET-----oo?-X-?|-MEo-M-B-T--M-M--T--oT??-E-oo-M-E-|E-M-----X?-XXT--M??o--T-o-XB-E?--|-----MMX-??--B|ooE
o|-X--|E-E--|-E-----M-ETMBo-T-o-|Bo--M-To-M-o--|---oXoTBM---|-----X-|---TTBX---?-|-E---?XoB-B--??EoB-----E?|-E-?T--EM-MT?-M--T-|--?-oT?BE-T-?M-E-o--EMo---o-?--EBB--?BT|--T---|?T|o--M----XoET-Xo--BXM?E
-|-|--To-M--oooX----X-XXo-M---?--|o-E--E|---?--T---T|-TMM---|-----?-E---oMB|B--T-B-M---M-TT-X----T|B-----MEB-X--B-BoE-EM--M--o-M----Xo?|B-X-Bo-T-o-o|BE?--X-B|-XB?--TXEM------BXM|B--?----MBX?-Xo---BBTB
mo-M---o-B----M|----M--E|MT-M-|-?oB-B|-||-M-T--?---oTX|oT---B-----?-?---XM?EB--|-X-B----?||----o?To------X|o-T-oo---B-?oT-o--E-o--B-?TXXX---oo-X-o-MXMTB--|-EB-oo|--oTTX--E---E?EE---X----XBT?-MB--o?o?M
XXXXXXXXXXXXXXXXXXXXXXXXXXXXXXXXXXXXXXXXXXXXXXXXXXXXXXXXXXXXXXXXXXXXXXXXXXXXXXXXXXXXXXXXXXXXXXXXXXXXXXXXXXXXXXXXXXXXXXXXXXXXXXXXXXXXXXXXXXXXXXXXXXXXXXXXXXXXXXXXXXXXXXXXXXXXXXXXXXXXXXXXXXXXXXXXXXXXXXXX
