--X-??-E-E--o?-Xo-EE-M-ME||-TE?--B-ME--BB-|-|-?E-|-|-M--M-MM--TXBXEX----B-M|X---o---o--B-?B-oX?-MMoo----?o?-BMM?o----o-M|-oMT--|o|---X--X--E-B--?|---|---|-o---oo--?XoBoXTXB--oX?-BB-E-|-o-----BMEE-|oB|
M---B--?-B--MBMTX-?o-oXB?Xo-BME----T|--MX-o--|BM-B-|-X--|-?T-ET|T|MX----|-EM----T---T--o-|--XB|-XT?M---MMBM-XBoBM----?--|-TTT--?EE---E-----o-M--TE---o-----T-E-Mo---X|oEoX??--MXB--o-M-o-MX-----|Eo-oXo-
T-M--M-o-|--o?EE|-ME-BE?XMX-o|o--E-XE--EM-o-X-oE-M-M-T--?-TX--M-TEE?----?-M|E---o---B--E-M|-?EB-B|ME----ToT-|XMoo----X-?o-|-----E|------|--M-X---X---B---o-o-X-|?--?TE|MM||E--XEB-E?|M-X-TX----??BM-BBEX
X-X-oE-B-X--X--T?-?--M|X?----BB--X-EE--T|-E-ME|E---o-E--?-X?-MT|o-?X----E-?MT---B---|--E-EE-EoB-EEMo---TTTB-BBETM----B-oo-B?---?ME---o-----X----?B---M---T-?-E-MT----T?|XMBT--?oB-X?BM-X-E?----oTEB-T?o?
E-?-ET-?-T--METEo-|--XTBXX|-EoM----BE--oM-?-BE?M-?-B-|--M-ME-oM|X?X-----M-BXo---M---E--o-oT--Eo-|E-B---M|M|-BT?oE----|-?E-|XM--B-?---E--T--B----MT-------E-o-?-?E---EoooEM??--??B-EX|X-E-XM----|T?M-E?B?
|-X-B?------EMTM|-oX--M?ToE-?Mo--?-??--TM-?-|T?M-M-?-T--B-XM-XB|TT-M----M--M?---B---M--B-XM-|E?--o|----?T-B---B?T----T-M?-TM|--XT?---M-----E-?--M?---E---M---E-|X--BX-|?XoM?---X|-MEMM-?-MM----oTT|-EoB-
o-E-??-?-?---oBTE-oE-MB-TBT-BEX--|-oT--XT-?-ET||-?-|-X--M-XB-T?|?|B-----X-XM?---?---|--B-MX-|BT-?B?M---?-|B-XE?-|----B-E|-T|T--E?o------M--E-T--oo---E---o---M-EE--TBBMM?B??---?B-?-X--M-?E----BX||-BEM|
E-|-To-B-o--BXMB--XB-?MXT|?--Eo--|-MM---E-T-MXMM-?-B----E-X--EBE?E-o----T-TBX---B------o-B?-TBT-BMXX---TEEM-|TMBB----X-EM-XoX--BMT---o-----E-B--?T-------o-?-T-?X--EXBB|ToM|--MB--M???-B-T-----E|XE-MoBv
--?-Xo-M-----TMT---X-|oToX?-Bo|--E-M|--TX-o-||TT---|-o--T-X--BXo-oXB----M-o?B---B---T--X-|X-oTE-B|-M---E----MXEE?----B-?M-MMB--?|o---M--?--E-B--Xo---M---T-B---X?--?BEET?XX---Eo|--?---B-MM----oToM-||Mo
?-X-BB---B--MMoEE-EX-T?XX-E-?X?--X-EX--X--E-EoM?-B---X--|-XM--|MMoo-------TTM-------B--T-TX-BTE-T?oE----BEE-o-BT|----X-oo--ME--BXM---M--T--o-|--|M---T-----B-?-||--MEB|?M-|M--oE--??EB-|-?|----|-XE-B|E?
--T-|X-|-o--XEE-?-E|-MoE?|E-XX?--T-|o--TE-|-oBT|---|-B--B-?M-MBoXoEo----o-MMM---?---B--X-B?-|TX-T|?X---BoM?-MoooE----M-ET-?BM--E-?---T--B--o-E--ME---E---o-E-|-ME--MMoEME-ME--BXM-BM?X-B-?B----?o??-?E?-
T-|-E|-X----EBME?-|X-?MX-o?-oXE--M-TB---X-T-X?o--X-B-M--|-X|-T?o|??o------?Xo---M---X--M----TMM-T-oB---?MEX-TT?o?----|-MT-o|?--?M----|--M--T-|--?|---T---|-M-E-oE--TXoTTTM?|--XM|-M?X?-|--X----oEXM-ETMT
E-E-M|-T-|--X--oo-E?--EMBMB-|T?--?-Xo--ET-o-oTo|-|-T-M--E-TB-EBMBXTM----?--B|---?---o--M-M|-ME|-MoBM---oEMT-TBE?-------Xo-?-|---|?---M--o--T-E---?---X---M-B-?--T--M?BMBTXM|--E?E-X|M--T-o|----oXTE-EoTM
B-|-TM-|-E--TE|Xo-XX-?EB?|o--XM--X-E|--oE-M-EXBM-E-X-o--E-B|-?TMoo?o----X-M?M---X---?--T-EB-BoB-MXoo---BXo?-T?XTo----M-||-ETB--E?X---X--E--E-M--M|-------E-X-M-M---oMEoB?|oX--TB?-?||X-T-?B----M|MX-MEB|
m-T-o?-B-E--oXBoE-?--TX|TTT-M-E--?-EE--TM-B-E|TB-o-o-|--E-MB-EM-ME-B----B-XMX---T------B-MB-XMB-o|-E----?oT-EB?-M----o-|E-M-?--|?----E--|--T-B--E?---o-----X-?-o?--?|Too|oo?---?E-?|B?-T-BT----|B|T-|oE|
XXXXXXXXXXXXXXXXXXXXXXXXXXXXXXXXXXXXXXXXXXXXXXXXXXXXXXXXXXXXXXXXXXXXXXXXXXXXXXXXXXXXXXXXXXXXXXXXXXXXXXXXXXXXXXXXXXXXXXXXXXXXXXXXXXXXXXXXXXXXXXXXXXXXXXXXXXXXXXXXXXXXXXXXXXXXXXXXXXXXXXXXXXXXXXXXXXXXXXXX
