-------------------------------------------------------------------------------------------------------------------------------------------------XoTEB?Xo-?EEM-o|oE-XTX||T?--?ooE|BXTMM|?TXMoX-BT|XMEE|-
-------------------------------------------------------------------------------------------------------------------------------------------------EEX?ETo--|X?XMTTXTXE|MTXo-|MX?TT-EE?BoBoBTMXXTXE?T?-X?-
-------------------------------------------------------------------------------------------------------------------------------------------------E-Mo?BM|?-|?XXXM?MX?|TTXT?XMMXX?T?E-o-B|-B-||X-o?X?o-M-
-------------------------------------------------------------------------------------------------------------------------------------------------?XoM?-?E|T-oT-X-X-TToE??XT|-oTTME|M?MMXTMB-?MMoMTo-|oM-
-------------------------------------------------------------------------------------------------------------------------------------------------EE?-E|BBoMT?EBB?EBT-T?|XEMTEMT-?TXTXMBTX-oBX|XBoTMBEEo-
--------------------------------------------------------------------------------------------------------------------------------------------------?ETTTEoB-B|E|-XToXXBEoXETMB||oETBo?oM|T---oX|M|X-oX|E-
-------------------------------------------------------------------------------------------------------------------------------------------------oT|-XBEEX?T|EBXM|BM-X?B??XBB|?Eo-T?ooXB?o--EB?B?MT-o|X-
-------------------------------------------------------------------------------------------------------------------------------------------------T|oMMBB?MTET||Xo----TX----T|T?M??M-TE-TMMM-TB-MEME??B-v
-------------------------------------------------------------------------------------------------------------------------------------------------EE?EM?M-oo-T-|?Mo|BoEBooBEBXE?E--TT|MB|?BBMEXT?E||X|XMf
-------------------------------------------------------------------------------------------------------------------------------------------------?MoBoMXo|BBX|EXMX-XMT|MBoM-|--oX|XEoXX?TMBB?-T?BoBoE-Xf
-------------------------------------------------------------------------------------------------------------------------------------------------BoMEME?EETXM?BBB-oBTX?M?|BBTMo||MTXMo?BEoToMT|??MMoEBMf
--------------------------------------------------------------------------------------------------------------------------------------------------oT|EEXMXXXTo?XX-MMM|T|??EBoTEM?T-X?|-|BM|-?TTTEB?BM?Mf
-------------------------------------------------------------------------------------------------------------------------------------------------E|o-X-?TEBT|MBX|XEo|B-?MXoXMTMXMEoTo-|-TM-?MXXEX|TTXM-f
-------------------------------------------------------------------------------------------------------------------------------------------------|EXEMMMEE|XM-oXEX?M|-T?XE---XoB?BBETME||EBXXoEXo-EoBTXf
m------------------------------------------------------------------------------------------------------------------------------------------------M?EBX??BET-BT|M|EXMM-M?|MMB--|oXEE|EEoMXBMEB??TBoM-?MMX
XXXXXXXXXXXXXXXXXXXXXXXXXXXXXXXXXXXXXXXXXXXXXXXXXXXXXXXXXXXXXXXXXXXXXXXXXXXXXXXXXXXXXXXXXXXXXXXXXXXXXXXXXXXXXXXXXXXXXXXXXXXXXXXXXXXXXXXXXXXXXXXXXX-XXXXXXXXXXXXXXXXXXXXXXXXXXXXXXXXXXXXXXXXXXXXXXXXXXXXX
