------------------------------------------------------------------------------------------------------------------------------------------------------------------------------------------------------o-
------------------------------------------------------------------------------------------------------------------------------------------------------------------------------------------------------E-
------------------------------------------------------------------------------------------------------------------------------------------------------------------------------------------------------?-
------------------------------------------------------------------------------------------------------------------------------------------------------------------------------------------------------|-
------------------------------------------------------------------------------------------------------------------------------------------------------------------------------------------------------X-
------------------------------------------------------------------------------------------------------------------------------------------------------------------------------------------------------X-
------------------------------------------------------------------------------------------------------------------------------------------------------------------------------------------------------?-
------------------------------------------------------------------------------------------------------------------------------------------------------------------------------------------------------Tv
------------------------------------------------------------------------------------------------------------------------------------------------------------------------------------------------------Ef
------------------------------------------------------------------------------------------------------------------------------------------------------------------------------------------------------Ef
------------------------------------------------------------------------------------------------------------------------------------------------------------------------------------------------------Xf
------------------------------------------------------------------------------------------------------------------------------------------------------------------------------------------------------Mf
------------------------------------------------------------------------------------------------------------------------------------------------------------------------------------------------------Ef
------------------------------------------------------------------------------------------------------------------------------------------------------------------------------------------------------of
m-----------------------------------------------------------------------------------------------------------------------------------------------------------------------------------------------------MX
XXXXXXXXXXXXXXXXXXXXXXXXXXXXXXXXXXXXXXXXXXXXXXXXXXXXXXXXXXXXXXXXXXXXXXXXXXXXXXXXXXXXXXXXXXXXXXXXXXXXXXXXXXXXXXXXXXXXXXXXXXXXXXXXXXXXXXXXXXXXXXXXXXXXXXXXXXXXXXXXXXXXXXXXXXXXXXXXXXXXXXXXXXXXXXXXXXXXXXXX
