-------------------------------------------------------------------------------------------------------------------------------------------------------------------------------------------------BMEMo|-
-----------------------------------------------------------------------------------------------------------------------------------------------------------------------------------------------B|BX||||-
-----------------------------------------------------------------------------------------------------------------------------------------------------------------------------------------------MT-TET|X-
-----------------------------------------------------------------------------------------------------------------------------------------------------------------------------------------------MMBXM--M-
-----------------------------------------------------------------------------------------------------------------------------------------------------------------------------------------------oBBM|XMX-
-----------------------------------------------------------------------------------------------------------------------------------------------------------------------------------------------??TT--?E-
-----------------------------------------------------------------------------------------------------------------------------------------------------------------------------------------------|-EX?BT--
-----------------------------------------------------------------------------------------------------------------------------------------------------------------------------------------------Bo?o--?Tv
-----------------------------------------------------------------------------------------------------------------------------------------------------------------------------------------------||o-?XB-f
-----------------------------------------------------------------------------------------------------------------------------------------------------------------------------------------------X-ooBXEMf
------------------------------------------------------------------------------------------------------------------------------------------------------------------------------------------------?-?MM|Mf
-----------------------------------------------------------------------------------------------------------------------------------------------------------------------------------------------EooXE?E?f
-----------------------------------------------------------------------------------------------------------------------------------------------------------------------------------------------o-?MXXT?f
-----------------------------------------------------------------------------------------------------------------------------------------------------------------------------------------------MMoMo?TBf
m----------------------------------------------------------------------------------------------------------------------------------------------------------------------------------------------MBTXEXMBX
XXXXXXXXXXXXXXXXXX-XXXXXXXXXXXXXXXXXXXXXXXXXXXXXXXXXXXXXXXXXXXXXXXXXXXXXXXXXXXXXXXXXXXXXXXXXXXXXXXXXXXXXXXXXX-XXXXXXXXXXXXXXXXXXXXXXXXXXXXXXX-XXXXXXXXXXXXXXXXXXXXXXXXXXXXXXXXXXXXXXXXXXXXXXXXXXXXXXXXXX
