----EBo-M-B--M--M-XM|XoB--?T-T-EMMXM--o-BX-BMB--EMXE--BE?---o-oo-T-MXE-E?oM--oo--o?T?ToE?B---Eo?EBX-E||-|-T---|-o-B|-|-BX--TTMEoX-ToBEEMT---X|oX-?X?-|--XX|-oToB-X---M-?M-?o-E-o--M--ET---MX-M|-?E--M-E-
--o-?BB-M-?-MB--M-BMXXB---X-MB-EX-BE--E-XB-EM---oo|X---|T--TT--o-T-?EoTEB??T-M|--||T-??XTE??-EToXoM-EXX-E-|---M-T-MoBT-oB--?X?TT|--B|-EEB--|ETB|-TM|-?-EXET--XBT-EMEM?-T|-|B-To---o--ME--E-E-EB-X?--o---
----TBX-o-|-?B--o-|EXMX?--BEoM-Xo-B---M--|-M-B---|TB--oXT--?E-Mo-T-|T-TEX|?X-T?--ET?B|--T||M-|B?BoE-X-E-E-M---|-o-?MX?-T----M?TTo-XEoBoT---MB?ME-TXM-B-TTMT-TT|T-|-X---|B-M--oX|--X--oX---B?-|--TE--|-?-
--|-X-B-M-|-?E--E-oTTXE|--|-??-|XTTM--T-o?--EB--EMEE---?M--EM-MM-E-TEXTEMToo-EB--??TMoo|BMMX-EE|?-o--T?---E---?-X-oMBB-EE--T|XBME-MX-X?TE--||T|X-TX--M-TMoX-X-BX-?B-|B-?E-??-|BT--M--|X--|XT-M?-?X--o??-
--T-XTX-X---BB--o-|EBTMo--ETo?-|MM-o--T-|T-o-X---B|---?|T--?--XT-M-ooo?|?MEE-BB---?|E|??XME?---E-oo-XoE-|-E---X-o-XBE?-XM--ooo?TE--ETXXEB--?XTT|-B?B-X-MX-T-|X?X-MTBE?--o-BB-M?X--X---B---MX-E|-Eo--T-M-
--?-??M-M-?-oT--M-B-BEM|--B?M|-?-?-B--T-?---E---o|TM--T?---EB-B--T-BBX?-|T-M-XX--?TT-BMMME?B-??XBo|-T---X-M-----T-o|oB--o--|TXoBX-BM|-XM?--MoBT--?-E-X-BMX?--EB--oBM?M-E--X?-EoM--B--?T--BoX-?X-TX--T-X-
--|-M?B-B-o-XT--o-?XB?TX--MX-T-ToEXX--X-BE-BM?--E?BM--T|T--|--Xo-o---E-?X?M--TE--MTMTM-TXoTT-B|X?BTBMMo-|-T---X-X-TB|X-XM---?TE?T-ET-E?E?--oM|BE-X-|---oToX--MoB-oE|XM-MM-ET-TX---o---|--BB--E?-B|--E-o-
--?-??|-T-X-?E--?--??X-?--TE-?-?X?|M--?-Eo-XXE--TM-o--BEE--EE--B-o-???||-B?--o?--E|oo|EXXo-?---TXEE-X??-T-?---E-|-?ME|-??--|MBBT---EM-oBo--TMET|-E-|-?-B-BT-TE|X-EM--T-o--EX-X?o--E--To--B|E-EB-TM--?--v
--B-B?--M-o--E--o-EoBTXM--X?-?-o-T-o--X-B|-ooX--BoXE--|MX--T|-EX-M-oET-?M|-|-oB--EB??EBE|?MM-BE|TTX-?|M-|-?---T-|-|T?B-M---XM?BTB-o-?-?oM---?E|o-X|E-E-TX-o-XBBo-|?o|X-MM-TT-TM---|--MB--EMB-BB-TM--|-Tf
--?-ooB-?---|---|--?-Mo----Xo|-MooXM--X-o|-XT---?E-X--T--E-?---M-o-MToMTM-?--X---|---|T?ME-M-?TMBo?-M?o-o-|--||-X-XE|o-oo--XBXBXB-o|?oEE?--o??|--oBM-E-o?o|-?MXo-TX-|T-??-|?-T?|-----X|--B-o-M--TB--M-?f
--M-M?M-M-|--B--X-oM|?TT--TMET-MXMBM--T-|--||o--XM-E---E?--oT-?|-|-MME?B|X?|-MT--oE?|X?o?BEo-|-|T|o-MXT-|-E---X-o-M|MB-ME--MoToMB-EE|?oM?--EETXM-BB|-o-TE|B-|o----T-M|-M?-Xo-ETT--M--?---TBX-M?--B--X-Xf
--E-BXE-T-T-ME--o--TXEoo--M-BX-X?BE------X-EBX--?XoB--?Mo--o?-|M---M-T?-?-MX-EE--B-??E|oEEBo-TTT|??-||o-T-E---o-B-EXoo-oB--o-BEBT-TX?XT-o--EEoEE-oo--|-M-?|-B||--X?TET-TB-Xo-oT---?--?M--ooB-XT-XE----of
--o-TBM-?-?-M-----Eo??oM--XT?E-MBT-|--B-MB-|?T--E-|?--oT?--?E-MX-o-?oE|MBMoM-|---MEMo-XTX?MT-XBM--|?X-o-X-E-----E-MMoM-XT--XE|MT--XTX??Xo--Eo?TM-?|o---?ooo-To---???Mo-MT--o-o|E--?--E---MT--||-EX----of
--T-B?X-M-E-XB--E-XMEEME--?M|B-??XT---X-|M-T?B--X|M|--??X--B|-oM-T-ETEoMEMB--BM--?Xo|-T|B?o?-|-BoT?-XEo-E-X---B-B-o--T-o|--B|-oMB-EBXTE-E--o??TX-MT--E-?-?--oEX|-EBBoM--E-o?-?EM--X---T--EBo-|T-MM----Bf
m-X-E|?-M-B-?M--T-XBE?|---TTM--E|XXX--T-oo-TXB--EM|T--E|E--|M--|-|-E???ToM?B-BM--EMMXXMMo-Bo-|TM--E-TME-T-|---E---?T||-|X--Eo?M|o-MBE|o-B--|--E|-MTX-E-BM-X-XM|T-BT|M|-E--T?-BBM--T--ET--M|B-o|-T?--X-XX
XXXXXXXXXXXXXXXXXXXXXXXXXXXXXXXXXXXXXXXXXXXXXXXXXXXXXXXXXXXXXXXXXXXXXXXXXXXXXXXXXXXXXXXXXXXXXXXXXXXXXXXXXXXXXXXXXXXXXXXXXXXXXXXXXXXXXXXXXXXXXXXXXXXXXXXXXXXXXXXXXXXXXXXXXXXXXXXXXXXXXXXXXXXXXXXXXXXXXXXX
