----E--------------------M---------E-----------------------?---------------------------------M------------------------EMMo----------M----B-B-----------M------------E--------?---------X-----o---?---E-E
|--B----B---o------M----------------MB--o-----E--X-----X-------------------X----?---E---------------------------B---------------M-M-----X---------------X---B--------------------------------EE--XB---EB
B-o------------?----o-----------?------E--X-X-------------?-----------------o--------M--------------------------MB-----------------------X--------M--?-----------------------------B?-----------------MX
T-o-------------------------BM---------M------MM-----------X-B------------o--E------oM--------------EM--------oM--------X-----X---------------o------------------?-----E----------------E-----------M-TB
E----E----------B----------------------------E--------?------o-E----oE-----------------------------X----------E----B----------------------------------------------------X-----X----o--------oE-X---o--XX
oo-----E------------B-B-----B------E----------------------M----------X---------------?--------X--------------X------------?--o--------------?-?--------------------------------?---B-------------?M---XE
X?----EB-------------------------?o---X--X--------------------------------B---B---o------------------------X---------------------E--------o-o----?---------X---------------------------?---------------|
M---------------B--------------------------------E-----------------EX---B-X-------M--E--------------B--------------E--X---M--------X--------o-XB------E--------B---------------E----------?--X-E------?v
?-------------B---E-----------M-------?X-----X--------o--------o----------------------------------------X---E--X-------------------------------------------?--------------E--------X------------------BT
o----?---------------?----------------------E----------------------------?-------------X--E?------------------?-------------o?--E-----------X---------------------------------------E------------o---oTX
B-----M----------------X-------------------------------------M---------------M---------------------------------M-------E----------------------E-------B-X--------E---o-------------------E------------E?
?---?----?----M-----B------------M--------------X--E-----------------------E---B---------B-----B----------o------?-?----------X----------------------------?-----B--E--?----X-X-----------------------oo
M-------------------E-------?----?--------------------o--------------B--------X--E-----M--------B-B-------------B---------------------------------------?-------o-E-----------M--oEE---?-o-------BB--T-X
o--------------M--------------?----------------o-----------------o----?---------------B-----B-------E---------------M---------M-----------X-o-------------------o-------E---------X-------------------BX
mX---------XMo----------X--o-------EXXE---X-M-B--X-------------X---------B---------X-??--------X------------------XX-o-----------X--X---X----------E---B------X---X-X-----------o-----Xo-----X-------X|o
X-XXXXXXXXX-XXXXXXXXXXXX-XXXXXXXXXXX--XXXX-XXXXXX-X-XXXXXXXXXXXMXXXX-XXXXXXXXXXXXXX-XXXXXXXX-XX-XXXXXXXXXXXX-XXXXX-XXXXXXXXXXXXXX-XX-XXX-XXXXXXXXXXXXXXXXXXXXX-XXX-X?XXX-XXXXXXXXXXXXXXXXX-X--XXXXXXX-XX
