--------------------------------------------------------------------------------------------------------------------------------------------------------------------------------------------------------
---------------------------?----------------------------------------------------------------------------------------------------------------------------------------------------------------------------
--------------------------------------------------------------------------------------------------------------------------------------------------------------------------------------------------------
--------------------------------------------------------------------------------------------------------------------------------------------------------------------------------------------------------
------------B----------------------------------------XX-------------------------------------------------------------------------------------------------------------------------------------------------
----------------------------------------------------XXXXXXXX------------------------------------------------------------------------------o-------------------------------------------------------------
--------------------------------------------------------------------------------------------------------------------------------------------------------------------------------------------------------
-------------------------------------------------------------------------------------------------------------------------------------------------------------------------------------------------------v
----------------------------------------------------------------------------------------------------------------------------------------------------------------------X--------------------------------f
---------------------------------------------------------------------------------------------------------X-------------------------------------------X-------------------------------------------------f
--------------------------------------------------------------------------------------------------------XX---------------------------------------------------------------------------------------------f
--------------------------------------------------B----------------------------------------------------XXX---------------------------------------------------------------------------------------------f
------------------------------------------------------------------------------------------------------XXXX---------------------------------------------------------------------------------------------f
----------------------------------------------------------X------------------------------------------XXXXX---------------------------------------------------------------------------------------------f
m---------------------------------------------XXXX--------XX--------------------------------------E-XXXXXX----------------------------------------------E----------------------------------------------X
XXXXXXXXXXXXXXXXXXXXXXX---XXXXXXXXXXXXXXXXXXXXXXXXXXXXXXXXXXXXXXXXXXXXXXXXXXXXXXXXXXXXXXXXXXXXXXXXXXXXXXXXXXXXXXXXXXXXXXXXXXXXXXXXXXXXXXXXXXXXXXXXXXXXXXXXXXXXXXXXXXXXXXXXXXXXXXXXXXXXXXX--XXXXXXXXXXXXX
