-----------------------------------------------------------------------------------------------------------------------------------X--------------------------------------------------------------------
---------------------------------------------------------------------------------------------------------------------------------------------o----------------------------------------------------------
------------------------------------------XXXXX---------------------------------------------------------------------------------------------------------------------------------------------------------
-----------------------------------------------------------------------------------------------------------------------------------------------------------------------------------------------------o--
--------------------------------------------------------------------------------------------------------------------------------------------------------------------------------------------------------
----------------------------------------------------------M---------------------------------------------------------------------------------------------------------------------------------------------
--------------------------------------------------------------------------------------------------------------------------------------------------------------------------------------------------------
-----------------------------------------------------------XXXX----------------------------------------------------------------------------------------------------------------------------------------v
------------------------------------------------------------------------------------------------------------------------------------------------------------------X------------------------------------f
--T--------------------------------------------------------------------------------------------------------------------------------------------------------------XX------------------------------------f
--|-------------------------------------------------------------------------------BBBBB-X-----------------------------------------------------------------------XXX------------------------------------f
--|-------------------------------------X----------------------------------------------XX------------BBBBB-----------------------------------------------------XXXX------------------------------------f
--|------------------------------------XX---------------------------------------------XXX---------------------------------------------------------------------XXXXX------------------------------------f
--|-----------------------------------XXX--------M-----------------------------------XXXX--------------------------------------------------------------------XXXXXX--------------T---------------------f
m-|-------------X--------------------XXXX-------------------------------------------XXXXX-------------------------------------------------------------------XXXXXXX--------------|---------------------X
XX|XXXXXXXXXXXXXXXXXXXXXX------XXXXXXXXXXXXXXXXXXXXXXXXXXXXXXXXXXXXXXXXXXXXXXXXXXXXXXXXXXXXXXXXXXXXXXXXXXXXXXXXXXXXXXXXXXXXXXXXXXXXXXXXXXXXXXXXXXXXXXXXXXXXXXXXXXXXXXXXXXXXXXXXXX|XX-----XXXXXXXXXXXXXXX
