-----------------------------------------------------------------------------------------------------------------------------------------------------------------------------?E?-||o-EB|-oo?X|oXo|ET-MB-
-----------------------------------------------------------------------------------------------------------------------------------------------------------------------------EE|?||EMTMM-EE-ME-?BB-To?T-
-----------------------------------------------------------------------------------------------------------------------------------------------------------------------------|o?B??M-oE?EM?To|EoT?TB|?|-
-----------------------------------------------------------------------------------------------------------------------------------------------------------------------------?BMM?-XTMXMMooT-TB-XXE?TB?-
-----------------------------------------------------------------------------------------------------------------------------------------------------------------------------BoEoE|XX?T-BMTEoBXTB|-M?|M-
-----------------------------------------------------------------------------------------------------------------------------------------------------------------------------To-oT?XM?T??-XTE??BE?oB-B|-
-----------------------------------------------------------------------------------------------------------------------------------------------------------------------------MXMMB-XEooE|?o-BXBTT||E?|X-
-----------------------------------------------------------------------------------------------------------------------------------------------------------------------------M-M|?|BXTMBoEMTM?B?T-EoXB?v
-----------------------------------------------------------------------------------------------------------------------------------------------------------------------------?MTT|XT-XE|MoT|ETo-XXX-T?|f
-----------------------------------------------------------------------------------------------------------------------------------------------------------------------------ME|TXE-oM|o?M|T??EXoB-|XTof
-----------------------------------------------------------------------------------------------------------------------------------------------------------------------------XXEoTMB?XX?oMX?B-EB-EBoXMMf
-----------------------------------------------------------------------------------------------------------------------------------------------------------------------------?XXET?-XBX?ooETTo-MEoB-?oXf
-----------------------------------------------------------------------------------------------------------------------------------------------------------------------------M|E|??oE|EXE|XMBB-oTE??|Bof
-----------------------------------------------------------------------------------------------------------------------------------------------------------------------------TT?MBT--?BEXEBT?|MB?-oXEEEf
m----------------------------------------------------------------------------------------------------------------------------------------------------------------------------MEoBBMM|--X?ToMMT??MBMTMM-E
XXXXXXXXXXXXXXXXXXXXXXXXXXXXXXXXXXXXXXXXXXXXXXXXXXXXXXXXXXXXXXXXXXXXXXXXXXXXXXXXXXXXXXXXXXXXXXXXXXXXXXX-XXX-XXXXXXXXXXXXXXXXXXXXXXXXXXXXXXXXXXXXXXXXXXXXXXXXXXXXXXXXXXXXXXXXXXXXXXXXXXXXXXXXXX-XXXXXXXXX
