------------------------------------------------------------------------------------------------------------------------------------------------------------------------------------------------TT?BTM|-
------------------------------------------------------------------------------------------------------------------------------------------------------------------------------------------------E-BTM|--
-------------------------------------------------------------------------------------------------------------------------------------------------------------------------------------------------|?XETT-
------------------------------------------------------------------------------------------------------------------------------------------------------------------------------------------------XoBoT||-
------------------------------------------------------------------------------------------------------------------------------------------------------------------------------------------------|oo--o--
-------------------------------------------------------------------------------------------------------------------------------------------------------------------------------------------------|TEo?X-
-------------------------------------------------------------------------------------------------------------------------------------------------------------------------------------------------TXET-E-
------------------------------------------------------------------------------------------------------------------------------------------------------------------------------------------------oB-ooX|v
-------------------------------------------------------------------------------------------------------------------------------------------------------------------------------------------------M|-BMXf
------------------------------------------------------------------------------------------------------------------------------------------------------------------------------------------------MBXo?M?f
------------------------------------------------------------------------------------------------------------------------------------------------------------------------------------------------o-B??BEf
------------------------------------------------------------------------------------------------------------------------------------------------------------------------------------------------XXX|EMMf
-------------------------------------------------------------------------------------------------------------------------------------------------------------------------------------------------oMX|B-f
------------------------------------------------------------------------------------------------------------------------------------------------------------------------------------------------?MEXETMf
m--------------------------------------------------------X-------------------------------X------------X-------X----X-------------X--X-X-----X------------X----------------X-X-----X-------------oMBE?XBX
XXXX-XXXXXXXXXXXXXX-XXXXXXXXXXXXXXXX-XX-XXXXXX--XXXXXXXXX-XXXXXXXXXXXXXXXXXXXXXXXX-XXX-X--XXXXXXXXXXXX--XXXXXX-XXXX-XXXXXXXXXXXXX-XX-X-XXXXX-XXXXXXXXXXXX-XXXXXXXXXXXXXXXX-X-XXXXX--XX-XXX-XXXXXXXXXX-XX
