--------------------------------------------------------------------------------------------------------------------------------------------------------------------------------------------------------
--------------------------------------------------------------------------------------------------------------------------------------------------------------------------------------------------------
--------------------------------------------------------------------------------------------------------------------------------------------------------------------------------------------------------
--------------------------------------------------------------------------------------------------------------------------------------------------------------------------------------------------------
--------------------------------------------------------------------------------------------------------------------------------------------------------------------------------------------------------
--------------------------------------------------------------------------------------------------------------------------------------------------------------------------------------------------------
--------------------------------------------------------------------------------------------------------------------------------------------------------------------------------------------------------
-------------------------------------------------------------------------------------------------------------------------------------------------------------------------------------------------------v
-------------------------------------------------------------------------------------------------------------------------------------------------------------------------------------------------------f
-------------------------------------------------------------------------------------------------------------------------------------------------------------------------------------------------------f
-------------------------------------------------------------------------------------------------------------------------------------------------------------------------------------------------------f
-------------------------------------------------------------------------------------------------------------------------------------------------------------------------------------------------------f
-------------------------------------------------------------------------------------------------------------------------------------------------------------------------------------------------------f
-------------------------------------------------------------------------------------------------------------------------------------------------------------------------------------------------------f
m--X---X-X---------X------X----X--X--X---X-----------------X---X---X-------X-----------X-----------------------------X------------------------X--------------------------------X--------------------X--X
XX--XXX-X--XXXXX-XX-XXXXX--X-X--XX-XX-X-X-XXXXXXXXXXX-XXXXX-XXX-XXX-XXXXXXX-XXXX-XXX-XX-XXXXXXXXXX-XXXXXXXXXXXXXXXXXX-X-XXXXX-XXXXXXXX-XXXXXXX-XXXXXXXXXXXXX-XXXXXXXX-XXXXXXXXX-XXXXXXXXXXXXXXXXXXXX--XX
