---------------------------------------------------------------------------------------------------------------------------------------------------------------------------------------------------|EXT-
---------------------------------------------------------------------------------------------------------------------------------------------------------------------------------------------------|?XT-
----------------------------------------------------------------------------------------------------------------------------------------------------------------------------------------------------MEX-
---------------------------------------------------------------------------------------------------------------------------------------------------------------------------------------------------B|oE-
---------------------------------------------------------------------------------------------------------------------------------------------------------------------------------------------------ETT?-
---------------------------------------------------------------------------------------------------------------------------------------------------------------------------------------------------XXMB-
---------------------------------------------------------------------------------------------------------------------------------------------------------------------------------------------------ETEX-
---------------------------------------------------------------------------------------------------------------------------------------------------------------------------------------------------TEXov
----------------------------------------------------------------------------------------------------------------------------------------------------------------------------------------------------T?Xf
---------------------------------------------------------------------------------------------------------------------------------------------------------------------------------------------------|-X?f
---------------------------------------------------------------------------------------------------------------------------------------------------------------------------------------------------oXM?f
----------------------------------------------------------------------------------------------------------------------------------------------------------------------------------------------------??Mf
---------------------------------------------------------------------------------------------------------------------------------------------------------------------------------------------------?E-?f
---------------------------------------------------------------------------------------------------------------------------------------------------------------------------------------------------TMEXf
m------X--------------------------------------------------------X-----------X---X---------------------X----------X-----------------------------X-------------------------------------X-X------------oMXX
XXXXXXX-XXXXXXXXXXXXXXXXXXXXXXX-XXXXXXXXXXXXXXXXXXXXXXXXXXXXX-XX-XXXXXXXXXXX-XXX-XXXXXXXXXXXXXXXXXXXXX-XXXXX-XXX--XXXXXXXXXXXXXXXXXXXXXXXXXXXXX-XX-XXXXXXXXXXX-XXXXX-X-XXXX-XXXXXXXXX-X-XXXXXXX-XXXXXXXX
