-o|-BBXMoX--BBo?----|--|BTE-X-EB-TT|---MM-B-o-X|---oE|--o?B--ooXMXoM|-?B|XBEXEo?oMXT-T-?EB-XT--BMo-E|XX??-|?TTX-?-EXoEMo|o-|---EMXMEE-B?--TXo--XB--?-MToE|?B-X-TT---ETE-o-MoXM-XM-EoBXE--TT|T?|B-M|-?B--
-|?T-EEoME--E?|XM-?oE--|XoMBoXT|--TT---||-X--?|B--|-??---?E-oB-E?MMEMB-E-|-|ToTX|||B-X-M-B-?XT-?---|-X-BE-?X?oXX?--EMB-?XX-M-X-ME-||-TXX--|B--M-BMME-BTBXTMB-TXB|-X-MB|o---TE?B-E-M??oo--oTT|o?o-o|BoT--
-EX-BBooE---T|-oT---X--XTX|-BTMT-o-M--?----B--o?|o?B|T--B|X-|Too---ooX-|o-BMoTEooMTXTB-M?X--oX-ETB-?BoEXM-ToXToEB-oTXoMMMB-oXT--TXEXB|Mo--|EX--B|?|XXE|T|EBM---ME-B-XB-|E-o?TT-|--XT|TTM--EBTEMo-|MXBE--
-?--M|X?-o--?T--||MM---METo-oT-B-ooT--|XM--X-TBMXM|o-?--X-MEEoXXXEXM||XET-E-Eo|oEoE?-o-E|BMo-E-M||-TT?XXo-BMXTM---XMBo|XE?-T|E-|?-E?oX|X--o|B-BXMT?-?BXMT-|E-MoTE-M-ooX---|T|Xo|--X|T|o--TTM-BX?-o---T--
--o-?|X-Xo---XTBBoEo----E?EB-TT--?|X--o?E-MX-MMT?--ooX---M-?X-MB--XTT-EEE|-?TM|Eo-ET-T-TBXEEEM--ET-oTooXM--ETXToB-E---XBEX-XMB--MXB-?|To--??o-oX|TX|oET||XBE-XXMX-E-|BX|?-BE-X--E-MB-----?||M-XX-BXM|o--
-ET?-M-|oE--?-|Eo--Xo--?|oX-?|-?--E---ooE--?-|EB?oBMB---M-oE|oEoMXME?T|-M-?B-ooTM-??---XB-XE|--|E--??XT?E-T?|-E|o-|-o?--|o-|oM-T|XX|M|M?---MB-MBBTXoMBT||ooB--|BX-M-o|M---oMoTTo--T|E-Mo--|-ET---oX|XM--
-M--B-XX-?--T?ME-E|-|--?MMT-?TXT-E----TEE-|T-XXoM-?EXM--MoX?E-E?-BMMBXX-E-M-M||?||MM-?-M-MT|-M-o-M--E-ooE-EB?ToB---BEB|o-M-E-o-o?XMME-oE--|?o-BTEBo-BEX---XX-|-E--T-M---|-BMBTXoT-XB-E-|-XEXXE-X-oX-?---
-X----oXBE--|-EMX-|?M--M?-BM|o---B-?---MM--|--oBM-M-----Bo-EooEB?EooX?-E?-oMTo-oTM?|----oX|?B|-EXoB?XM|?E-BM--EM--ME-EXo-?-|-?-XTT---EX?--oT--?|TTTX?TTT|----E|T?--EoM?---B-EooB|-|X-|ME|-XX-MTB--ETBB-v
-?X-o--M?E--TooBX?X-o--EE|E|TE-B-EXB--ETE--T-E-T-MBEE?--XMMX|EMTo|-E|-Eo--T|oBo-X?-T-B-MBMB-oE-E-B-MEM?o|-oBTTTXo-oXTTTE?M--oE-X-BE-B--B-?-TE--?XB-ToXTEo|Xo--|?o-E--??-B---|--B?-|BXE-T-XoTEoB?-Eo?M?-f
-EM-|-||oB---|-?oM-|X--?TMBBo?TT-To|--T-X-TM-T|BXXX|MT---BTE-ET-XB||oTX-B-T?Eo|-XX-X-X-?|?TT||-B-T-TMTB-M--?EXE?X-oMX?o-T---TX-EXEMEE|E---MBM-oME-?|EB?|MXXE--??--X--TT---B|?EX-o-BB-|B?-|?|MXBT-BEMo|-f
--T-|X?oXBM-|M?EMXX|---?-TXE--Mo-M??--T?o-B|-Eo||-?EEM--T|BT|oEBXXMB??MBT-?MME-XoBT|-o-Xoo-?E---BE-ETTTMo-To?Tooo-E-EoooEB--TE-oE--TM-?|--?|--Mo|BTM?XXBE|Mo-BBEo----ME-M-M|MTTo--EoMT|M-|-TXEX|-EBoET-f
-|T-TEEBXM---MooXXX-X--EB|MXTEM?-X||--EET-ET-|M||MEBBM--BE||B-|TEB--T-oTB-M?o|MB|B-|-?--XM-MoT-X-T-T-EXB?-BBX-T|o-BTBE||?--BTE--?MMT-M?T--MEM--|T|o?EoM|o|EE-ooB--T-XT--B-X||B?E?-|oBBBM-|-|BEo--T|-oE-f
-|-T??E-EX--??B-X-|-?-----TB---T-XTT--M||-ME-o|M-T?-TB--|oToBBT?XMoEMB-Xo-X-ETX?BoXM---ooMTX?|--|o-|-oMXB-oXoEM|M-oXEMX-o-E|Eo-|-X??B-MT--|BE-EX-?B-TX|TTBME-?T|T-M--?B---BXXX--?--To|X?-XM??XM?-T|?-?-f
-|X-TEB?B----||X?X??B--?-BEMo?EE-Bo|---T|-MT-|XM-|TM-M--EX-o|BBBM-B--oM-X-XEoB-B?oo?----EME?X?---B-|?--B-EE-|EoEX-E-?ooTBB-oB?-ooT--?XEX--TBX-M?|-|?EME-XX|E-B|E|-|-T-|-X-oM-B--M-TME-M---MBBBEX-|o-XE-f
mo---?B|E---BBo?|oBEE--oM|-X-BMM--TX--EET-oB-oMo-X|XoB--X-|-|T-MXXoXX-B-|-TBo?-X-XMB-X-?o---M|-|-o-MB?oM?-M?T--M?-|-MT?T---oBB-E|X-X|TET--oT--EoooX-M-XX?EBo-ToET-|-?|M---X?--XMT-TT-|M?-X-o-E-o-Xo?X--X
XXXXXXXXXXXXXXXXXXXXXXXXXXXXXXXXXX-XXXXXXXXXXXXXXXXXXXX-XXXXXXXXX-XXX-XXXXXXXXXXXX-XXXXXXMXXXX-XXXXX-X-XX-XXXXXXXXXXXXXXXXXXXXXXX-XXXXXXXXXXXXXXXXXXXXX-XXXXXXXXXXX-XXXXXXXXXX-XXXXXXXXXXXXXXXXXXXXXXXXX
