---------------------------------------------------------------------------------------------------------------------------------------------------------------------------------------oBBT|ET|EM|?o|-X-
---------------------------------------------------------------------------------------------------------------------------------------------------------------------------------------TBE|?ET-|TXXTXXB-
---------------------------------------------------------------------------------------------------------------------------------------------------------------------------------------?TE-?B|TToTEEEXE-
---------------------------------------------------------------------------------------------------------------------------------------------------------------------------------------TBEo-BToB-MX-BT--
---------------------------------------------------------------------------------------------------------------------------------------------------------------------------------------BB-BBoX|XX|BETMX-
---------------------------------------------------------------------------------------------------------------------------------------------------------------------------------------E-TM-?T?XBBM?EMX-
---------------------------------------------------------------------------------------------------------------------------------------------------------------------------------------E?--?ETo|M|T-|oo-
---------------------------------------------------------------------------------------------------------------------------------------------------------------------------------------?|BTBoo|M|EEo||Bv
---------------------------------------------------------------------------------------------------------------------------------------------------------------------------------------BMTEE?Eo--BMM?|of
---------------------------------------------------------------------------------------------------------------------------------------------------------------------------------------E-B?oB-B-|o||To-f
---------------------------------------------------------------------------------------------------------------------------------------------------------------------------------------?M|B--BX?XooTT-Bf
----------------------------------------------------------------------------------------------------------------------------------------------------------------------------------------Bo-BEXBMo-TB?EEf
---------------------------------------------------------------------------------------------------------------------------------------------------------------------------------------|MMBE?Mo-XXMoB?Bf
---------------------------------------------------------------------------------------------------------------------------------------------------------------------------------------ET-?X?MTBEoX-MT|f
m--------------------------------------------------------------------------------------------------------------------------------------------------------------------------------------TX?T?-|-?M?oEEBTX
XXXXXXXXXXXXXXXXXXXXXXXXXXXXXXXXXXXXXXXXXXXXXXXXXXXXXXXXXXXXXXXXXXXXXXXXXXXXXXXXXXXXXXXXXXXXXXXXXXXXXXXXXXXXXXXXXXXXXXXXXXXXXXXXXXXXXXXXXXXXXXX-XXXXXXXXXXXXXXXXXXXXXX-XXXX-XXXXXXXXXXXXXXXXXXXXXXXXXXXX
