---------------------------------------------------------------------------------------------------------------------------------------------------------------------------------------------?M?EBXMMo--
---------------------------------------------------------------------------------------------------------------------------------------------------------------------------------------------TB|?BE-?X--
---------------------------------------------------------------------------------------------------------------------------------------------------------------------------------------------XTE|?MoTEE-
----------------------------------------------------------------------------------------------------------------------------------------------------------------------------------------------?XMo??-Xo-
---------------------------------------------------------------------------------------------------------------------------------------------------------------------------------------------M-MMTMME?o-
---------------------------------------------------------------------------------------------------------------------------------------------------------------------------------------------BMX|XMX?B?-
---------------------------------------------------------------------------------------------------------------------------------------------------------------------------------------------BoMXBoo-|--
---------------------------------------------------------------------------------------------------------------------------------------------------------------------------------------------E?M|??MTXTv
---------------------------------------------------------------------------------------------------------------------------------------------------------------------------------------------X|?X||EoXMf
---------------------------------------------------------------------------------------------------------------------------------------------------------------------------------------------MXMooo|EETf
---------------------------------------------------------------------------------------------------------------------------------------------------------------------------------------------XTM|X|--?-f
---------------------------------------------------------------------------------------------------------------------------------------------------------------------------------------------TT?BMX|oXMf
---------------------------------------------------------------------------------------------------------------------------------------------------------------------------------------------|MB|B|Mo??f
---------------------------------------------------------------------------------------------------------------------------------------------------------------------------------------------|M?T?o?X?|f
m-----------------------X--------------------------------------------------------------------------------------------------------------------------------------------------------------------?-||XTBo?oX
XXXXXXXXXXXXXXXXXXXXXXXX-XXXXXXXXXXXXXXXXXXXXXXXXXXXXXXXXXXXXXXXXXXXXXXXXXXXXXXXXXXXXXXXXXXXXXXXXXXXXXXXXXXXXXXXXXXXXXXXXXXXXXXXXXXXXXXXXXXXXXXXXXXXXXXXXXXXXXXXXXXXXXXXXXXXXXXXXXXXXXXXXXXXXXXXXXXXXXXX
