--------------------------------------------------------------------------------------------------------------------------------------------------------------------------------------------------------
-----------------------------------------------------------------------------------------------------------------------------------X--------------------------------------------------------------------
---------------------------------------------------------------B----------------------------------------------------------------------------------------------------------------------------------------
----------------------------------------------------------------------------------------------------------------------------------------------------M---------------------------------------------------
-----------------------------------------------------------------------------------------------o------o-------------------------------------------------------------------------------------------------
--------------------------------------------------------------------------------------------------------------------------------------------------------------------------------------------------------
--------------------------------------------------------------------------------------------------------------------------------------------------------------------------------------------------------
-------------------------------------------------------------------------------------------------------------------------------------------------------------------------------------------------------v
-------------------------------------------------------------------------------------------------------------------------------------------------------------------------------------------------------f
-------------------------------------------------------------------------------------------------------------------------------------------------------------------------------------------------------f
-------------------------------------------------------------------------------X-----------------------------------------------------------------------------------------------------------------------f
----B----------------------------------------------------------------------------------B-----------X----------------------B----------------------------------------------------------------------------f
----------------------------------------------------------------------------------------------------------------------------------------------------------o----------------------B---------------------f
-------------------------------M-----------------------------------------------------------------------------------------------------------------------------------------------------------------------f
m------------------------------------------------------------------------B--------------------------------------------------------------------------------------------------------------------?--------X
XXXXXXXXXXXXXXXXXXXXXXXXXXXXXXXXXXXXXXXXXXXXXXXXXXXXXXXXXXXXXXXXXXXXXXXXXXXXXXXXXXXXXXXXXXXXXXXXXXXXXXXXXXXXXXXXXXXXXXXXXXXXXXXXXXXXXXXXXXXXXXXXXXXXXXXXXXXXXXXXXXXXXXXXXXXXXXXXXXXXXXXXXXXXXXXXXXXXXXXX
