--X-??-MBEM-o?|X--B----M?||---?-EE?ME--B--B-B|X---??-o-TM--M--ToBXE?---EM-M|--oToo--o|X|M?B-oX?-MooB?-T-o-?--|MB|--X?-MM--o-E--?o----E--XX-MB-BE-M--T|--B|To?X-o---TBM?o-TM---BXEo-BTE--?X-B-M-EMEET-o--
----B--|oB?-MEET--XT--XBoXo---E-M-MT|?-M--T-BBMX---M-X-?|--T-ET?T|ME---??-EM--E-TBBBTXT?o|--XB|-XE?XE-XMo-M--?ooTX-|?-B---T-M--?E---|M---M-TT-X-oo--oo--M-ETMM-ME--|BXTE-XE----XMT-?BM-X-o-B-M-||Eo|-X--
--M--M-o?|B-o|-E---o--E?oMX---o-o-MXEB-E--o-?B?E-|M?-?-E?--X--MTTEE-----|-M|--oXoEToBETXXM|-?EB-BoMoo-o-M-T---MoME-To-M?--|BX--TE-M-|E--|--BE--oBB--BB--Eo|o||-|M-----BM-|T----E-TTo?M-XE|-X-?-X?BM?-B--
--X-oE-|EXX-XMoT--M?--|XM-----B-?X?EE|-T--o-B-?X-BEE---X?--?-MTTo-??----o-?M--XEB|MM|XEMEEE-EoB-EMM?X-oT|-B--?EM?M-E--oo--BM---XM-?-BX---M-|T-BTXB--BM--BTX??X-MX--|T--|-MX---?oEBB?-M-???-|-T-TTEBM-o--
--?-ET-TETB-M?oE--TT--TBEX|---M-|-|BE|-o----?XEX-MX--E-MM--E-oMoX?X?---Eo-BX--X-M-?-EMB??oT--Eo-|X-E?-oMT-|--o?X|?-|X-M?--||E--T--o--o--T|--X-XBME--?---TEXoMX-?|--T-BXo-MX---E??X-BMX-?BT-X-B-oT?M?-?--
--X-B?-BX---E-BM--XT--M?ToE---o-?-T??T-T--?--MMB-E|B-?-BB--M-XBETT-----M---M--X-BMX|M|T||XM-|E?--||M?-o?M-B--BBT?E-|o-XM--TXo--?T---oo---X-ET-E|oo--oE---M?-T--|?--oEEX?-oE---?XT-X?EM-XB?-X-B-?TT|o----
--E-??-M-?T--M?T---T--B-oBT---X-MMEoTM-X--o-ooXo-X---M-XM--B-T?M?|BE---XM-XM--o-?oB?|oBBBMX-|BT-?T?EE-B?E-B---?E?X-??-?E--T||--??---oM--MX-?T-XXM---ME--EoT-EX-ET--MoBoM-BE---E??ooX---EB?-?-B--X||--M--
--|-To-X-o?-BTBB------MXM|?---o-|EXMME----|-oBoM-BBB-M-?E----EBT?E-B---B?-TB--o-BBTX-T?ETB?-TBT-BMX?T-XTX-M--?MTMo-?o-|E--XXE--EM-T-BT-----??-BMEE------ooT??M-?M--MX?B|-oo----BBBTBT?-oMT-o-M-M|XEB-X-v
--?-Xo-T?-?--?oT--E---oTEX?---|--M|M|B-T--o-TBo?-E?o-E-XT----BX--oX?---|M-o?--oMB|ooTEo?X|X-oTE-BT-----ET-----EToT-??-B?--M-o--o|-|-XE--?E-||-Bo?T--MM--|T?B?X-XX--T|MET-XX---?oBTTMo--|E|-X-B-EToM--X-f
--X-BB--BB|-M?EE---T--?X|-E---?-M-MEXo-X--M-XEEM-?E?-|-||--M--|EMooo---T?-TT--BT-TBTBE?EETX-BTE-TEoMB-T-|-E--EBTTT-EB-?o---M?--|X-B-TM--T--BB-M-|M--BT--?-?BTT-|E--?|E|?--|---BE|???|B-?-X-T-X-E-XET-?-f
--T-|X-|Xo--XXB---??--oET|E---?-T|||oE-T--M-oEM--M?--?-BB--M-MBBXoEM---E|-MM--BM??XoBTTX-B?-|TX-To?ET-EBM-?--XoXT?-?M-EE--?|M--M--T-XE--Bo--E-MXMo--XE--|oTEoB-ME--ME?MM--X---|X-Bo?oX-o|T-T-E-Xo??M-?-f
--|-E|-?M-X-E-oE--oT--MXTo?---E-o?MTB-----o-BMBM-?XT-E--|--|-T?M|??E---XB-?X--|MMTT|XMToM---TMM-TBoM|-B?|-X--??EXB--T-|M--oXM--TM-M-TE--MX-EB-|?BE--XT--B||Moo-oE--o|XoT-M|---|M-BMBo?--|X-T-|-XEXME-|-f
--E-M|-T?|?-X?oo--B---EM?MB---?-MMMXoT-E--|-XEoo-XBE-o-XE--B-EBBBXTo---BB--B--TX?Xo-ooB|TM|-ME|-M?BT?-?oE-T--MEB?o-||-BX--?ET---|-T-o|--o--|--ETEM--MX--|MXBB---E--XBX-B-XX---M?EXBX---BTM-M-E-TXTEM-X-f
--|-TM-EoE?-TMEX--M|--EBM|o---M-XoXE|E-o--E-T-oo-|X--M-XE--|-?TEoo?B---o?-M?--X-XTMM?X?T-EB-BoB-MEo|M-MB?-?--oXMEo-X--X|--EEo--T?-?-MT--E|-To-|ToE--T----E?XoM-MM--ET-MB-|B---EBoX|oTX-X-|-o---E|MXB-B-f
m-T-o?-TMEM-o-?o--Xo--X|oTT---E-|TBEEE-T----EoME-?X--E-EE--B-EM-ME-E---X?-XM--oMT-?o-|||BMB-XMB-oE-B|-X-T-T--M?EoE--B-E|--ME?--|?-|-To--|--Eo--T-?--oo--?-MXEB-o----oETo-oE---|?EBBEB?-B?|-B-?-EB|To-T-X
XXXXXXXXXXXXXXXXXXXXXXXXXXXXXXXXXXXXXXXXXXXXXXXXXXXXXXXXXXXXXXXXXXXXXXXXXXXXXXXXXXXXXXXXXXXXXXXXXXXXXXXXXXXXXXXXXXXXXXXXXXXXXXXXXXXXXXXXXXXXXXXXXXXXXXXXXXXXXXXXXXXXXXXXXXXXXXXXXXXXXXXXXXXXXXXXXXXXXXXX
