-----------------------------------------------------------------------------------------------------------------------------------------------------------------|?MXE--B?|Mo?|oBE-oBBTBXMTo-TEBB-?|BXB-
----------------------------------------------------------------------------------------------------------------------------------------------------------------XE-XT--ET-MM?XTBB-?B?TMBEo|-T?EB?|MBXoM-
----------------------------------------------------------------------------------------------------------------------------------------------------------------?|?-ET|-|EMETM?TMBEoMMX?BE|-EBTM?B|XTE-E
----------------------------------------------------------------------------------------------------------------------------------------------------------------?o?X-X?||BX|M-TX?||XEMTT|T--?E?BoBX?M?M-
-----------------------------------------------------------------------------------------------------------------------------------------------------------------BMo--EE?MXM|?|o?MB?|M|To?BBBX|TM-|?oBB-
----------------------------------------------------------------------------------------------------------------------------------------------------------------MoEMX-X-T?|X-XXTM|XooM||EBoo|B-o|Eo|-oo-
----------------------------------------------------------------------------------------------------------------------------------------------------------------MME|oE?o---TTXT|-|--M???-X-B?--E-TB?|X|-
----------------------------------------------------------------------------------------------------------------------------------------------------------------??T-E?-oX|?-E|BM|?X?EM|MTX?X??oEME|E|T?v
----------------------------------------------------------------------------------------------------------------------------------------------------------------M|-MBXTE||M|??EMM|E-MX--EB|EE-|ET?E--MMf
----------------------------------------------------------------------------------------------------------------------------------------------------------------T?XoX|EXo?TB|M-?MB?X?TMo||BBX?-EME-TEMXf
----------------------------------------------------------------------------------------------------------------------------------------------------------------M??--MMM||?X-o-B?|-EXT|X?T-EE|MoX-EooBMf
----------------------------------------------------------------------------------------------------------------------------------------------------------------B|EMTBT?BBBEEET|XXBooMEB--?|oBB?M-XTE?Tf
----------------------------------------------------------------------------------------------------------------------------------------------------------------M?|??M|oX|-ME|MXo?-BTMoTMEBEXoBT-ToB|B|f
----------------------------------------------------------------------------------------------------------------------------------------------------------------M-|X?TB|BX|EM|-MXBMXT?|BE?MB|XX-X|XXX|Bf
m----------------------------------------------------------------------------------------------------------------------------------------------------------------o??X?XX?X|MEX?XT|XoT-|-XBBEETBM|EoXoTXX
XXXXXXXXXXXXXXXXXXXXXXXXXXXXXXXXXXXXXXXXXXXXXXXXXXXXXXXXXXXXXXXXXXXXXXXXXXXXXXXXXXXXXXXXXXXXXXXXXXXXXXXXXXXXXXXXXXXXXX-XXXXXXXXXXXXXXXXXXXXXXXXXXXXXXXXXXXXXXXXXXXXXXXXXXXXXXXXXXXXXXXXXXXXXXXXXXXXXXXXX
