----------------------------------------------------------------------------------------------------------B---------------------------------------------------------------------------------------------
-----------------------------------?------------------------------------------------------------------------------B------------------------------------------------------------------------------B-B----
---------------------------------------------------------------------------------------------------------------------------------------------------------------------------------------X----------------
-----------------E---------------o----------------------------------------------------E----------------------------------------------------------------------------o------------------------------------
-oE--B--o--------------------B--------------------------------------------------------------------------------------------------------------------------------------B----B------------------------------
---------------------------------------------------------------------------------------------------------------------------o--B------------------------------------o------------------------------------
--------------------B-----------------------------------------------------------------------------------------------------------------------------------------------------------------------------------
-------------------------M--------------------------------B----------------------------------------------------B----------------------------------------------------------------B-----------------M----v
-------------------------------X----------------------------------------------------o--------------------------------------------------------o--B--B-----------X---------------------------------------f
--------B-----------------------------------------B--------------------------------------------X----------------------?--B-------------------------------------------------B------------------B---o----f
--------------------------------------------------------------------------------------------------------------------------------------------------------------B---------B-------------o----------------f
-------------------------------------------B--------------------------------------------------------------------------B----X----------------------------------------------------------------------X----f
--------------B------------------------------------------------X---------------------------------------------------------------------------------------------------------------------------------------f
-------------------------------------------------------------------------------------------------------------------------------------------------------------------------------------------------------f
m--------------------------------------------------------------------------------------------X-X---------E----------------------------------XB--------------------X------------------------------------X
XXXXXXXXXXXXXXXXXXXXXXXXXXXXXXXXXXXXXXXXXXXXXXXXXXXXXXXXXXXXXXXXXXXXXXXXXXXXXXXXXXXXXXXXXXXXX-X-XXXXXXXXXXXXXX-X-XXXXXXXXXXXXXXXXXXXXXXXXXXX-XXXXXXXXXXXXXX-XXXXXXXXXXXXXXXXXXXXXXXX-XXXXXXXXXXXXXXXXXXX
