?|ET?-X------------------------------------------------------------------------------------------------------------------------------------------------------------------------------------------------X
BMTBXM|------------------------------------------------------------------------------------------------------------------------------------------------------------------------------------------------X
BXTTT|-------------------------------------------------------------------------------------------------------------------------------------------------------------------------------------------------E
-M|-TTX------------------------------------------------------------------------------------------------------------------------------------------------------------------------------------------------X
-B-MM??------------------------------------------------------------------------------------------------------------------------------------------------------------------------------------------------B
oB??oTE------------------------------------------------------------------------------------------------------------------------------------------------------------------------------------------------T
TBXEoBo-------------------------------------------------------------------------------------------------------------------------------------------------------------------------------------------------
M?BE|?B------------------------------------------------------------------------------------------------------------------------------------------------------------------------------------------------v
|-TX-|-------------------------------------------------------------------------------------------------------------------------------------------------------------------------------------------------X
Bo--|ME------------------------------------------------------------------------------------------------------------------------------------------------------------------------------------------------T
?M?oEB?------------------------------------------------------------------------------------------------------------------------------------------------------------------------------------------------|
?B||?EB------------------------------------------------------------------------------------------------------------------------------------------------------------------------------------------------|
XTooE|o------------------------------------------------------------------------------------------------------------------------------------------------------------------------------------------------M
XMBBXT-------------------------------------------------------------------------------------------------------------------------------------------------------------------------------------------------|
mEBo-Bo---------------------------------------------------------------------------X----------------------------------------------------------------------X---------------------------------X---------X-|
XXXXXXXXXXXXXXXXXXXXXXXXXXXXXXXXXXXXXXXXXXXXXXXXXXXXXXXXXXXXXXXXXXXXXXXXXXXXXXXXXX-XXXXXXXXXXXXXXXXXXXXXXXXXXXXXXXXXXXXXXXXXXXXXXXXXXXXXXXXXXXXXXXXXXXXXX-XXXXXXXXXXXXXXXXXXXXXXXXXXXXXXXXX-XXXXXXXXX-XX
