----E------?-------------Mo--------E-----------------------?---------------------------------M-------------------------MMo----------M----B-------------M----------M-E--------------X---------o----E--E-E
|----M------o------M---------E------MB--o-----E--X------X--------?--------XX----?----E--------------------------B--B------------M-M-----X-----------------------M----------------o------------E--X----EB
B-o------------X----o----------------B----X---------------?-----------------o--------M------------------------B--B-----------------------X--------M--?-------E--?-------------------------------------MX
T-o-------------------------B-?---------------MM-----------X-B------------o--E------oM--------------EM--------oM---o---EX-----X----------------------------------------E---X----------E-------------M?TB
E----E----------B--?-------------------MX----E---------------o---o--oE-----------------------------X---o------E----B-----------------------------------oB---------------X-------E--o--------o-BX------XX
oo----E-------------B----?-BB------E----------------------M--------------------------?M----------------------X---------------o--------------?-?----------------X------------o------B-----------------MXE
X?-----B-------------------------?o------X-------------------------?------B--------------------------------X---------------------E--------o-o----?-----------------B-----------------o-?---------------|
M---------------B-------------------?------------E-----------------EX---B-X-------M--E-------------XB-?------------EX-X---M----o---X--------o-B-------E--------------------------------E-?-----E------?v
?---E---------B---E---------X---------?X-------------o---------o----------------------------------------X---E--X-------------------------------------------?---------M-------------X------------------BT
o----?---------------?----------------------E----------------E-----------?-------------X--E?--------------------------?-----o?--E-----------X-------B-------------------------------------------------TX
B----M---------------E-X----------------M--------------------o-----------------M-------------------------------M------------------------------------X-B-X--------E---------------------E------E-------E?
?---?----?----M-----B--------?---M-------E---------E--------M--------X---------B---------BE----B----------o------?-?----------X----------------------------------B--E--?------X--------------------E--oo
M-------------------E---------------------------------o-------------EB--------X--E-----M-------XB---------------BE------------------------------------o-?-------o-E--------------o-E-----o-------BB--T-X
o-------E--------------------------------------o-----------------o----?---------------B-----B-----B?E--------M------M---------M--------E--X-o---------------------------E------------------------E----BX
mX---------XMo-------------oX--------XE---X-M-B--X-------Xo----X---------B---------X--?--------X------------------XX-------X--X--X--X---X-----------E--B------X-----X------------------o----------E---|o
X-XXXXXXX-X-XXXXXXXXXXXXXXXX-XXXXXXXX-XXXX-XXXXXX-X-XXXXX-XXXXX-XXXX-XXXXXXXXXXXXXX-XX-XXXXX-XX-XXXXXXXXXXXX-XXXXX-XXXXXXXX-XX-XX-XX-XXX-XXX-XXXXXXXXXXXXXXXXX-XXXXX?XXX-XXXXXXXXXXXXXXXXXXX-XXX-XXXXXXX
