B----------------------------------------------------------------------X---------------------------BMB-------------------------------------------------------------------------------------------------X
?----------------------------------------------------------------------?---------------------------T-|M------------------------------------------------------------------------------------------------E
|----------------------------------------------------------------------M---------------------------|EoT------------------------------------------------------------------------------------------------|
X----------------------------------------------------------------------E---------------------------M||?-----------------------B------------------------------------------------------------------------X
|--------------------------------------------------------------------------------------------------BBMM------------------------------------------------------------------------------------------------X
M----------------------------------------------------------------------?---------------------------|MM?------------------------------------------------------------------------------------------------E
B----------------------------------------------------------------------X---------------------------?o?|------------------------------------------------------------------------------------------------?
o-----------------X----------------------------------------------------?---------------------------XT-o------------------------------------------------------------------------------------------------v
----------------------------------B------------------------------------M---------------------------TM|X------------------------------------------------------------------------------------------------?
B---------------------------------------------------------------------T----------------------------M|||------------------------------------------------------------------------------------------------T
T--------------------------------------------------------------------------------------------------T-ET------------------------------------------------------------------------------------------------X
T----------------------------------------------------------------------o----------------------------T?T------------------------------------M-----------------------------------------------------------X
-----------------------------------------------------------------------E---------------------------||-E-----------------------------B----------X-------------------------------------------------------o
o----------------------------------------------------------------------?---------------------------EXB-------------------------------------------------------------------------------------------------o
m------------------X------------X--------------------------------------B--------------------X------XB-T---------------------------------------X--------XX------X-----XX------------X-----------------XXX
XX-X-XXXXX--XXXXXXX-XXXXXXXXXXXX-XXXXXXXXXXXXXXXXXXX-XXX--XXXXXXXXXXXXXXXXXXXXXXXXXXXXXXXXXX-XXXXXXXXX-XXX-XXXXXXXXXXXXXXXX-XXXXXXXXXXXXXXXXXX-XX-XX-XX--XXXXXX-XXXXX---XXXXXXXXXXX-XXXXXXXXXXXXXXXXX--X
