----------------------------------------------------------------------------------------------------------------------------------------------------------------------------------------------------Bo|-
---------------------------------------------------------------------------------------------------------------------------------------------------------------------------------------------------|XXo-
-----------------------------------------------------------------------------------------------------------------------------------------------------------------------------------------------------EE-
---------------------------------------------------------------------------------------------------------------------------------------------------------------------------------------------------EEM?-
---------------------------------------------------------------------------------------------------------------------------------------------------------------------------------------------------MMEE-
-----------------------------------------------------------------------------------------------------------------------------------------------------------------------------------------------------TT-
----------------------------------------------------------------------------------------------------------------------------------------------------------------------------------------------------|TX-
---------------------------------------------------------------------------------------------------------------------------------------------------------------------------------------------------|MTXv
---------------------------------------------------------------------------------------------------------------------------------------------------------------------------------------------------E--|f
---------------------------------------------------------------------------------------------------------------------------------------------------------------------------------------------------MXMof
---------------------------------------------------------------------------------------------------------------------------------------------------------------------------------------------------XE-|f
---------------------------------------------------------------------------------------------------------------------------------------------------------------------------------------------------ToB?f
---------------------------------------------------------------------------------------------------------------------------------------------------------------------------------------------------B-MBf
----------------------------------------------------------------------------------------------------------------------------------------------------------------------------------------------------TBof
m--------------------X-------------------------X----X---------------------------------------------X-X-------------------------------------------X------------------------------------X-------------o?MXX
XXXXXXXXXXXXXXXXXXXXX-XXXXXXXXXXXXXXXXXXXXXXXXX-XXXX-XXXXXXXXXXXXXXXXXXXXXXXXXXXXXXXXXXXXXXXXXXXXX-X-XXXXXXXXXXXXXXXXXXXXXXXXXXXXXXXXXXXXXXXXXXX-XXXXXXXXXXXXXXXXXXXXXXXXXXXXXXXXXXXX-XXXXXXXXXXXXXXXXXX
