--------------------------------------------------------------------------------------------------------------------------------------------------------------------------------------------------------
---------------------------------------------------------------B----------------------------------------------------------------------------------------------------------------------------------------
---------------------------------------------------------------B----------------------------------------------------------------------------------------------------------------------------------------
----------------------------------------------------------------------------------------------------------------------------------------------------M---------------------------------------------------
--------------------------------------------------------------------------------------------------------------------------------------------------------------------------------------------------------
--------------------------------------------------------------------------------------------------------------------------------------------------------------------------------------------------------
--------------------------------------------------------------------------------------------------------------------------------------------------------------------------------------------------------
---o-------------------------------------------------------------------------------------------------------------------------------------------B-------------------------------------------------------v
------------------------X----------------------------------------------------------------------------------------o-------------------------------------------------------------------------------------f
-----------------------------------------------------------M-------------------------------------------------------------------------------------------------------------------------------------------f
-------------------------------------------------------------------------------------------------------------------------------------------------o-----------------------------------------------------f
----B------------------------B--------------------------------------------------------------------------------------------B----------------------------------------------------------------------------f
---------------------------------------------------------------------------------------------------------------------------------------------------------------------------------B---------------------f
-------------------------------M----------------------------------------------------------------------------------------------------------------------------------------------------------------B------f
m--------------------------------------B---------------------------------B-----------------------------------------------------------------------------------------------------------------------------X
XXXXXXXXXXXXXXXXXXXXXXXXXXXXXXXXXXXXXXXXXXXXXXXXXXXXXXXXXXXXXXXXXXXXXXXXXXXXXXXXXXXXXXXXXXXXXXXXXXXXXX-XXXXXXXXXXXXXXXXXXXXXXXXXXXXXXXXXXXXXXXXXXXXXXXXXXXXXXXXXXXXXXXXXXXXXXXXXXXXXXXXXXXXXXXXXXXXXXXXX
