----------------------------------------------------------------------------------------------------------B---------o-----------------------------------------------------------------------------------
---------------------------------------------------------------------------------------------------------------------------------------------------------------------------------------B---------B-B----
--------------------------------------------B---------------M-----------------------------------------------------------------o-------------------------------------------------------------------------
------------------------------------B----B------------B-------------------------------------------------------------------------------------------------------------------------------------------------
--------o-----------------------------------------------------B------------------------B-------o-----B--------------o-----------------------------------------------------------------------------------
------o-------------------------------------------------------------------------------------------------------------------------------------------------------------------------------------------------
-----------------------------------------------------------------------------------------------------------------------B--------------------------------------------------------------------------------
----------------------------------B--------------------------------------------------------B-------------------B---------------------------------------------------------------------------------------v
---------------o------------B--X---------------------------o-----------------o--------------M---------------------------------------------B--------------------X---------------------------------------f
--------B------------------------------------------------------------------------------------------------------------------------------B-----------------o-----------------B------------------B--------f
-------------------------------------------B-----------------M--X-----------------------------o---------B---------------------------------------------------------------B-------------o----------------f
--------------------------------------------------o--------------------------------------------B------------------------o-------------------------X-----------------------------------------------X----f
--------------B------------------------------------------------X---------------------------------------------------------------------------------------------------------------------------------------f
-------------------------------------------------------------------------------------------------------------------------------------------------------------------------------------------------------f
m--------------------------------------------------------------------------------------------------------E------B-------------------------X------B-----------o-----------------------------------------X
XXXXXXXXXXXXXXXXXXXXXXXXXXXXXXXXXXXXXXXXXXXXXXXXXXXXXXXXXXXXXXXXXXXXXXXXXXXXXXXXXXXXXXXXX-XXXXXXXXXXXXXXXXXXXXXXXXXXXXXXXXXXXXXXXXXXXXXXXX-XXXXXXXXXXXXXXXX-XXXXXXXXXXXXXXXXXXXXXXXX-XXXXXXXXXXXXXXXXXXX
