B----------------------------------------------------------------------X---------------E-----------BMB-------------------------------------------------------------------------------------------------X
?----------------------------------------------------------------------?---------------------------T-|M------------------------------------------------------------------------------------------------E
|----------------------------------------------------------------------M---------------------------E-oT-------------------------------------------------?----------------------------------------------|
X----------------------------------------------------------------------E---------------B-----------M||?------------------------------------------------------------------------------------------------X
|--------------------------------------------------------------------------------------------------BBMM------------------------------------------------------------------------------------------------X
M----------------------------------------------------------------------?---------------T-----------|oM?------------------------------------------------------------------------------------------------E
B----------------------------------------------------------------------X---------------------------?-?|------------------------------------------------------------------------------------------------?
o------------------X---------------B-----------------------------------?---------------T-----------XT-o------------------------------------------------------------------------------------------------v
-----------------------------------------------------------------------M---------------o-----------TM|X------------------------------------------------------------------------------------------------?
B---------------------------------------------------------------------T----------------o-----------M|||------------------------------------------------------------------------------------------------T
T--------------------------------------------------------------------------------------|-----------T-ET------------------------------------------------------------------------------------------------X
T----------------------------------------------------------------------o---------------X------------T?T------------------------------------------------------------------------------------------------X
-----------------------------------------------------------------------E---------------T-----------||-E-----------------------------B----------X-------------------------------------------------------o
o----------------------------------------------------------------------?---------------M-----------EXB-------------------------------------------------------------------------------------------------o
m------------------X------------X--------------------------------------B---------------M----X------XB-T---------------------------------------X--------X--------------X------------X-----------------XXX
XX-XXXXXXX--XXXXXXX-XXXXXXXXXXXX-XXXXXXXXXXXXXXX-XXXXXXX--XXXXXXXXXXXXXXXXXXXXXXXXXXXXXXXXXX-XXXXXXXXX-XXXXXXXXXXXXXXXXXXXXXXXXXXXXXXXXXXXXXXX-XXXXX-XX-XXX-XXXXXXXXXXX-XXXXXXXXXXX-XXXXXXXXXXXXXXXXX--X
