-----------------X------------------------------------------------------------------------------------------------------------------------------------o-------------------------------------------------
--------------------------------------------------------------------------------------------------------------------------------------------------------------------------------------------------------
--------------------------------------------X-----------------------------------------------------------------------------------------------------------------------------------------------------------
--------------------------------------------------------------------------------------------------------------------------------------------------------------------------------------------------------
-------------------------------------------------------------------------------------------------------------------B----------------------------------------------------?-------------------------------
----------------------------------------------------------------------------------------------------?---------------------------------------------------------------------------------------------------
--------------------------------------------------------------------------------------------------------------------------------------------------------------------------------------------------------
---------------------------------------------------------------------------------------------------------X---------------------------------------------------------------------------------------------v
-------------------------------------------------------------------------------------------------------------------------------------------------------------------------------------------------------f
----------------------------------------------------------------o------------------------X-------------------------------------------------------------------------------------------------------------f
--------------------------------------------------------------------------------E----------------------------------------------------------------------------------------------------------------------f
-------------------------------------------------------------------------------------------------------B-----------------------------------------------------------------------------------------------f
-------------------------------------------------------------------------------------------------------------------------------------------------------------------------------------------------------f
-----------------------------------------------------------------------------------------------X-------------------------------------------------------------------------------------------------------f
m------------------------------------------------------------------------------------------------------------------------------------------------------------------X-----------------------------------X
XXXXXXXXXXXXXXXXXXXXXXXXXXXXXXXXXXXXXXXXXXXXXXXXXXXXXXXXXXXXXXXXXXXXXXXXXXXXXXXXXXXXXXXXXXXXXXXXXXXXXXXXXXXXXXXXXXXXXXXXXXXXXXXXXXXXXXXXXXXXXXXXXXXXXXXXXXXXXXXXXXX-XXXXXXXXXXXXXXXXXXXXXXXXXXXXXXXXXXXX
