E?--|-|X-?|BoBXE||--B-BEE-B--|X-M-oXMX-B--EMM-TMM--BM|-Eo---M-----B-----MMXMX--XoT-o---|BM-?X--|-EETT----BBB--oX?-X||BE-??E--MEM--|--TBMT-EBTB-o-|-BMMEB--X-?Mo-o--XEXo|--XT?-B|?MX------o--ET-??--T|B-|
M?-oE-oB-X?--||EB?--o-?MMBB?B---?XBBMT-||-M-B-XEo--|MooTo---|-B---o-o--T?oTEX--T|?X-----||TTT--E||MTX----TMT-EM-X-|E|-EXBMT--M?X--|-MEo|E-XoEo---M-M?BBM--o-XBMTX|--|T-XT-M||-o-oE??-----B-oT|-Mo--oBXT|
X--o|-T---|TooETBo--T-X?To?-oX--|oE?|X-E|-T-T-EBE--?X?|-----?-?---X-?--B?T-ME--M-|Mo---?T|o|M--T-XB-E-----E|-||-?-TMMo-||EE--ME|--o-XXoXT-|-XX-|-T-ToB|E----EoXMTM--XoMMT-?-|-?ME|Xo-----X-BE|-BT--EXETT
Eo--X-EM-XE-BBXM|o--M-XX|ME?XTB-B?BTTX-?T-|Eo-Xo|---Eo|oX---E-E---T-o--MEXooM--?X-T?---Bo--E|--E||ToE----BM?-?BT--?XoT?B-oB--?o---X--E-M|-XXTE---|-XM|XE----T-XMBo--E?EM|-?MB--|?TMM-----|--T--o|--XX??T
TE-T|-MB---MEE-X|B--M-M?-ET--o--E-o?X|-X?-TTT-B-B---T--B?---o-T---?-B--oBE|E?--Eo|BE---EM|-oT--oXMEo|-----X|-BE?E-M?|B|B||?--XEB--B-XEXE?-T|MT-X---oMToB--o-o|MToE-|||B||-|-X-o-M?To-------T||-oX--?|XX?
BM--X-XB-|?BM?BBoX--o-oT?XX-M|?-T-oX-?--B-|E|-BoE---MEX?B---|-----X-X--TMX?T?--BX?BT----XT?|B---T-EoB-----ME-|Eoo-TMB-TTM?T--|o|--X-EXBM|-MBXX---E-T|EBT--M-XMT|oo-B?EoTT--TT-XMoBBX-----T-BoT-o?--EXo|X
oB-|T--?-oBT|oMB||--T-oMM|M||T--?BTEMT-oX-?-E-E?X--EoB|X?---------o-o--BMEBBT--oBoT?---EE?X?B--||T|-E----??M-BXE|-MBE|XXXXE--EB?--?-TXB?--BM|--E-E-MM-BT--T-|TXBBE-Bo?|-?-T?|-oXXM|X-----M-EXo-BX--BXBMX
XE-BX-oT--MXE--BM---E-E-M-Eo?|o-T?T|||-X--BB|-BEM--EXB?To---B-B---T-B--B|oTME--?EMBB---|B-||E--?oETXT----|TM-??BM-ETMXEXMT|--EB|--X-TEoT|-o-TM-E-o-T?EMB--o-BBTooE-?XM--X-XoM-ET?E-B-----M-?-E-E?--??o|v
|E-XE-|X-oTETE||EM--?-|XXBBM-TX-B-?E-T-oB-o?B--T---MX-o|?---?-M---M-B--B|??E|--XToM|---T?|M|---TXo?TB----EoT-T?E|-XB-B|?|-?--?EB--|-||ToT-??XE-E-o-|?E?B--?-EEX-o|-T|oEX|-E|E-oXooEE-----X------X--BEEoM
EM-BM-oT-?-E|?-M?B--o-BEBM|??oX-M-B----BX-?X|-BXX---X?|B----X-M---|-M--XEXB||--XBB-?---oEoEX?--o-M-BX----T-T---?B-BBoXME-|X--|B|-----TT-o-MTo--|-X--B?-M----B|XEMT-?o-ETE-XB|-M|-BTT-----T-?||-|---B--?T
?B-ET-TX-??oB-|X?M--T---Mo?X|-M-?|BoM--oB-EE--XBB--E|?B?B---B-T---o-o--TXTMX?--BE-BT----E-oX|--BXTE|X----XXo-oBEB--M?EX-BMM--E?X--T-E?EoX-XX-T-X---MMB?o--|-TBM--M-oBEX|X-EM|-EE-o-X-----M--Bo--o--X?--T
X?-?T-XT-BEo--BX-|--E-|oB-T|-T|--oXE?o-Eo-|Eo-TT|--BT?oTX---X-|---o-M--MXBoBM---BMMX----|XMB---MMoXTE----ooE-XT?|-MB?M|-BBE--MoM--T-ToT??-|-oo-?-E--E-T-----XoTX?T-XEE?o|-EXo-oB-o??-----?-M?X-??--||o|?
X|-XX-BE-EBoB-|-|X--M-E|oEo-T-o-ToMT?T-|o-ME--?|X--oX?XTo---|-----X-E--ETT?X?--?X||B---MXoBoB--?-?BE|----E?T-EB?T--M-EXT?X---TX|--?--T?-E-BE?M-T-o-BEMM---o-??-E?B-X-|T|E-oB--??TBoM-----T-EBT-XX---XM?B
?|-|B--o-MT??oMXEM--X-XEE-MX-E?-XETB-?-||--TT-BTo--T|||TM---|-B---?----ToXE|?--T-BMM-----TT-X--EXX|M?----ME--XB-B-BX|BBM--|--o?M-----o?oB-TXBo-|-o-||BT?--X-BT?XB?-M|XEME-TE--XXM?B|-----o-|B?-Xo--EBB-X
mo-Mo-oo-BXEM--|-M--M--XM?TXM-|-XE|X?T--|-MMo-??|--oTBMXB---B-?---?-M--XX-?Eo--|MX|T---o?||----oEooE|----X|X-TXoo--|??-oT?X--E-o--B-|TXTX--Too-T-o-TXMEB--|-EMEo?|-E|TTXM-|T--|?ET-|-------TE?-MB--M?oX-
XXXXXXXXXXXXXXXXXXXXXXXXXXXXXXXXXXXXXXXXXXXXXXXXXXXXXXXXXXXXXXXXXXXXXXXXXXXXXXXXXXXXXXXXXXXXXXXXXXXXXXXXXXXXXXXXXXXXXXXXXXXXXXXXXXXXXXXXXXXXXXXXXXXXXXXXXXXXXXXXXXXXXXXXXXXXXXXXXXXXXXXXXXXXXXXXXXXXXXXX
