-----------------------------------------------------------------------------------------------------------------------------------------------------------------------BBX-EE-oXBEMTBoBBEoX|BTTT|EXToBX-
-----------------------------------------------------------------------------------------------------------------------------------------------------------------------o||o?|B-|Xo|To---MX|XEBTMoMBMT-o-
-----------------------------------------------------------------------------------------------------------------------------------------------------------------------TEM?E-X-T?XM|o|ToEMo?EX|EBTBX-EM-
-------------------------------------------------------------------------------------------------------------------------------------------------------------------------BBB?X?T-X?E?MBEX?EXBB-TToETME?-
-----------------------------------------------------------------------------------------------------------------------------------------------------------------------BXEMoo-oXE?TooXEMEBXoM|E-Xo|--M?-
-----------------------------------------------------------------------------------------------------------------------------------------------------------------------EETT-o||?-ooX|BEM-?EEBEB|B|||-X?-
------------------------------------------------------------------------------------------------------------------------------------------------------------------------EBo-Mo|X-B|BX?oEBoT|TTEooMoTEME-
-----------------------------------------------------------------------------------------------------------------------------------------------------------------------BME-BE?ooB|-TEoETE-BB-EET-MEEMTTv
-----------------------------------------------------------------------------------------------------------------------------------------------------------------------oEB?|-EX?EXE|oB|EETMTEBoXETB|E|Xf
-----------------------------------------------------------------------------------------------------------------------------------------------------------------------M-T?X?-oEB|EEoEX?EB?TTBBoo-?TooMf
-----------------------------------------------------------------------------------------------------------------------------------------------------------------------XMB-ToXo?o?|X|E|?-TXMXooTo-E?M?|f
-----------------------------------------------------------------------------------------------------------------------------------------------------------------------oB??ET?o?BMX-?XXTMTo|XMBEM-BTo?Mf
-----------------------------------------------------------------------------------------------------------------------------------------------------------------------EM-E-oX?-|oEM?XX|M|ET-ET-|-E-E?of
-----------------------------------------------------------------------------------------------------------------------------------------------------------------------EMoMMM?ETMoMMEB-BB|XooMET??-T???f
m-----------------------------------------------------------------------------------------------------------------------------------------------------------------------?MBBTX||X?XBXXBEXoMo|-X?BET|XT?X
XXXXXXXXXXXXXXXXXXXXXXXXXXXXXXXXXXXXXXXXXXXXXXXXXXXXXXXXXXXXXXXXXXXXXXXXXXXXXXXXXXXXXXXXXXXXXXXXXXXXX-XXXXXXXXXXXXXXXXXXXXXXXXXXXXXXXXXXXXXXXXXXXXXXXXXXXXXXXXXXXXXXXXXXXXXXXXXXXXXXXXXXXXXXXXXXXXXXXXXX
