--------------------------------------------------------------------------------------------------------------------------------------------------------------------------------------------------------
--------------------------------------------------------------------------------------------------------------------------------------------------------------------------------------------------------
--------------------------------------------------------------------------------------------------------------------------------------------------------------------------------------------------------
--------------------------------------------------------------------------------------------------------------------------------------------------------------------------------------------------------
--------------------------------------------------------------------------------------------------------------------------------------------------------------------------------------------------------
--------------------------------------------------------------------------------------------------------------------------------------------------------------------------------------------------------
--------------------------------------------------------------------------------------------------------------------------------------------------------------------------------------------------------
-------------------------------------------------------------------------------------------------------------------------------------------------------------------------------------------------------v
-------------------------------------------------------------------------------------------------------------------------------------------------------------------------------------------------------f
-------------------------------------------------------------------------------------------------------------------------------------------------------------------------------------------------------f
-------------------------------------------------------------------------------------------------------------------------------------------------------------------------------------------------------f
-------------------------------------------------------------------------------------------------------------------------------------------------------------------------------------------------------f
-------------------------------------------------------------------------------------------------------------------------------------------------------------------------------------------------------f
---------------------------------------------------------------------------------------X---------------------------------------------------------------------------------------------------------------f
m--X---X-----------XX---X------X--X--X---------------------X-------X-------X--------------------------------------------X--------------X--------------X------------------------------------------------X
XX--XXX-XX-XXXXX-XX--XXX-XXX-X--XX-XX-X-XXXXXXXXXXXXX--XXXX-XXXXXXX-XXXXXXX-XXXX-XXX-XX-XXX-XXXXXXXXXXXXXXXXXXXXXXXXXXXX-X-XXXXXXXX-XXX--XXXXXXXXXXXXX-XXXXXXXXXXXXX-XXX-XXXXXXXXXXXXX-XXXXXXXXXXXXXXXXX
