oBBoX?B--?MMBBM-?-?BMo-MX-?oX?-Xo-X-?-B-XTB-XT-X|MB?B?Mo--oB?MX-?EXTXoToB-B-MX?-B?E-ooB?B-?o-Bo|X-T?XMB?-MX?-Bo??--EMEM--oEXBMM-oXTXXooMo?XXMoE-X-B?-XXXoX??B-TB-TooMoXEooToBMBo-XET-M--BXBX|-BBoXBMBooB
TX-X?MB-MXXB?TBo-TM-?T?XXo-?XB-----?X--MB---BBo|---XX-MoBMoX-MXXBoEo-o--TX?---EX?EMX?o-oBB---ME?XM--?-BE?--M-o-Bo-o-?X-B-BBB|-XEoM-X-|o-X-?X?o|X|-TBM-o-M-M-|T-XE-|-T-B--Mo---Xo-oT---|--MX-M----Xo-BXo|
E?----oBBX-?T?BM-oTo-MB--EB--?o?B--BTE?M?MEoMoXETE-XoM?B?-BMoM-B?B----E---EMXXX-B--B-?M-M-B?-XX-X-BoMoTMBB?|----oo|-X?--?oXMo-?-?---Mo---oM--E?X-MX-B-XXM-BM-o-BXEoE--E-X--TB-XB-?B-MX-Mo-MM--?M?--oo?M-
|XE?X-?M-BMEo--MM|-B-M-BoMB--o--?T-Xo-MXB??X--?B-?-X-XX-X?-X-o-X-o-BBX-XB-BXo-oB---TMXB---BE-?M-BM-------B-o?XMX--oM-TBXX--M|B?---|--B|oXME-|oB-oBMBB--oT??-Xo--TMMBoMBM-T?MXB-?--|BBE---B?o?--MoMBBB-X-
-MX-|?XB?-XBo-B-oB--X?o---?X-B?-MEo----Mo-?-Xoo-?-?B-B---?--??MB-B-B--BM------??BEEX--?Mo-BB--oM-XBE-TMBMM-ooo-M-ooTX-XX?--B-M?EBBBX-TXM-X?B-M|--oX-B|?-BMTBM|EXo-BB---BE-oo--X-oXB-BM|BX?--EoXX?XX-B-X?
TMBX---X|-??oBo--?MXo-BXXo-TMBX-XBoo-T-XoXooBBM??-MoooT|-XB---oE-M?|-XBBT|-MEB-X|XoM-M-B----?MXEBMX-?----B-X-EBo--|-?-MBMB?-o-?-----X-BoB--EoX-|--E-|-XXX??--B---BMoB-oo-?BX?-E--Mo-ME-----o-----?X---M-
M--oEX-?MB-BX??o?BMX-o---XMB?-oX--BM----XBM-M--B|-B-?MoB-XTX-X??B--???-MX--|oT?-XM-E??BoXoTB-MB-X-X-||-XMoXB?o-BoBM?---oo---BX-METo-|Bo-oMX-?Bo-?BX?X?--MM|B-TMBB-BXM-??-MX-MTooM-oo|?-TM--|MXBMX--E-o-|
E-oXM-B?-?--B-B--M-oMT--MM-?E------X|B?X?-B-??-XBBEB-B-XXT--?B-?-B-?M?-BoM-B?M??-X|-o-B-MToBX--XB-XoTM-M-?---MM---oEM--X?--XB-MM|--MM-X-oX-oo---X?-M-M?X-oXMM---|-X-XMB?MoT-B-B----EM-|XBX-BoM?oT|E-M?-v
Eo---XBE?B?-|M?BB-oo-XXMoX-oEBB-Xo?|-?M---|-oEMoMXBBoX-Xo--B?EMXM?B-oooXMooX-MM-o-o-|-?-XM--BE??--?---o|--oMM??E-X?-oMBM-X-?o?-X|B--X-T-oX-?BEE--|o--?BX?B-XTB|-M----?o-oXTB?-o?oE??-B----X?--?ET-B?o?MT
M-EBM-E---?XM?X---X-M?Mo--B?--o---|Bo-MMMB??X-o--M---?M-B?MBX---?-XBM-M-B--T--BMX--E--M-XT-??M?|ooXE|-X|-M?--B-M--XB-B--BXMXBM?EMoo--o-X-M--?Bo|?XBE-XoM-EXTXX--T-oBMM--oT-?-BM-|o-oXXo|M-oEM--EB-MBX--?
||XMXEoTo-B-M?oB--TMMBoB?M?-XXX-M?BB-------M--X-Mo?|-MXoo-?oMo|-XB--To|?M-?XB--oX?MoX-|-X?BB-BT-MoToX-B-oo-E--??-?-E--M---XX-?oXoXM--oXXoXMo-Mo-X-X|-Xo|X-T?-BXMo-M-MTT?o---oB-B-?---B-oX-o-B--B|--B|MBT
BoM-o-----B-B--MX-XB-oX-?BX---o---?EMTXM?|-o??|--BEE----TX-X-oM--?oMMX-BB---X-?--M--?EoBB-ME-MX---MooXX--?M-X-X--TooE-BB?-XBBo---MMo-B-M?-XM----E-?XB-X?XM-M-M-BXMo-|-XM?-o-B?M--oM|M?--B?o-|X-?E|?-?M-B
?-T-??TEToX?-?--X-?M-XB-?-M-MXX|X??o?o?ME-o-X?ET--T--oE?MX-X--EMo-B--B-M?-o-MMTXXX?X??--o-oX--?oBMo?X-EX--XXM-o--MoBMBB-o?XBMMTX-ooEoE--T-?MB-?TB--X--BB-?X--?-o-XXBo-X?X-|----XB-o-BX|-?-?|BTM|E?B-BM-X
?E-MX?MM--M--EMBoo-BB-M-X-?-?-o---oM-MMo?o-M?BM?XXX?-o??ooMETTMXoX-|-B----oB-Eo--o-o-o-XMMo|M-?-?-XoEM-|MBX-|-M-?-X?oXE-BB-M-M-TB-M-B?|E--o----B-?oMM-XXMo?|-M-X-B-?--o?BoEBo|?-B-|--X--M-T-?-XE-oE?--MX
mXXXXXXXXXXXXXXXXXXXXXXXXXXXXXXXXXXXXXXXXXXXXXXXXXXXXXXXXXXXXXXXXXXXXXXXXXXXXXXXXXXXXXXXXXXXXXXXXXXXXXXXXXXXXXXXXXXXXXXXXXXXXXXXXXXXXXXXXXXXXXXXXXXXXXXXXXXXXXXXXXXXXXXXXXXXXXXXXXXXXXXXXXXXXXXXXXXXXXX-
X------------------------------------------------------------------------------------------------------------------------------------------------------------------------------------------------------X
