--E------|TM-XTB--XXB|-TTEB-M--|B-|-B-?|X||EEo-|Xo-?BXT------|M--To-?oBX--T----?|M-|--E-TXXXTX-X-T-B--X-X-o-E?--|B---X--oE--X?-B--XT---|----?-M-TBETM---B|B--E?TE-T-E---|-X|---||oo?-T--B-||X||-?-X|-o--
-oM---o---EB---?B-o-MT-M|TE-X-MT-E-MB-BE--M||M-EE-|-EoX-X----MM--EBX-EE|?-BX--oXXX-?--o-?X-TE?-o?X-|--||X---o?E--B---T--X---MX-T--M---Xo-|--o----|-T|-E-MXB--o-oB|MBo---XE-T-B-TE?EM-?--o-XoBX-E|-T?-EM-
-?T-E-T--?-E-|-E|EE-B|--|-XB---X|BXMB-?BM-MT---|-|-E||M-T----X---B-XEEBT?-T---T-TE-?--T-X|-??|---o-M--oE--M-EMM-oB-T?---EB?-oX-E--?X--MT-TEMX-?--ETTM-|--XT--XEMXBB-X---o-XX---TB|M--T--?-|---|-|-To--X-
-|----M---TM-|EM--oB-X-E|MTMT-TTEoB?B-T|T-oXoB-||-|?-B--MM---EE--TMMM-E-|-B---?----?--T-|B-E---M-M-o--T-E-M-TTX-M---E|--|E---M-B--||--oB-B-T--o-E-X-B-E-X----oXEB-?----|--|o-XB--|B|-X--?-ToM?E---To-|T-
-EM---o--T-T-|?|M-MoXo-X-X??X-o?XB||E-TXM-BTX---M-M-M?M-XB---To--E|T--T---|?--T|-T-o----To-EBo---X-T--XXM-?-MXM-T---TB--?EX-oE-B--E?--o|--XEE-B-oME-o---o|o--o|??-M-|-----X?-MTXB-X|-M--o--??o?-?-|M-?T-
-TE---o--T|X-o|BX-XEM|---?-ET-BBo?|MB-TM?-?MT-|-o--E|X|-MM---|?--EEoX--T--Eo--?|ME-X--?-X--o?o-T-X-oE-?BB-?-X-X-?E--X---BMB-T|-T--?---oB-o-o?-T--B--X---M----?T-T----|--T-oM-|B-?BTB-X--|--ETMM-?-|--XB-
-EB---B--|M?-Mo-E-o--?-|-XMX?-|MX---M-o-T-TEB--M--TBEE?-T|--EE---BEX-MMBo-X|--oo||-B--?-B--|---M-?B---M-E-E-T-T-EE--MT---Bo-EB-E--XB--BX-EMMM-|-M--MX-|-|X---XTXBBX-T-T-X--X-|-XE-TT-X--T-EEXE-T--Eo-EM-
-TB---?--EEM-o|-M--|o--T-o-TM-?-EXoB?-TX--?o??----?B-T?--X---B|--BET?MXB?-TE--o??M-B--T-MTTMBo-T---?-?|-o---|oB-T?---?--?XM-Xo-E---T--oX-?EMo-E-MTMM?-o-EE---?--Eo|-?---E-E--X-XXEBT-X--o-ooX-B-o--B-o-v
------E--oB--XE-o-TEMB-|E-To---o-T-T--TBo--Bo?-M--MXEB?-|o----X--o-EM|XB--|M--TE-M-X--B--B-XBE--------?TT-?--?M-TE---E--|T--XX-o--BM--X?-oMEo-E-Bo?XE-B---B--M-oETX-----T-|--M--BEM|-X--M--?|oT-T-B|-M?f
-Eo---X---T--|ooXTTMXX--E-EE||T?XT-E--o?--Eoo---M--oB-|--?---TM---T?-XoTB-ET--EMXE||--B-Eo-?o?-|-E-|--TXo-T-??|--T--Eo--MMT-|E-E---M---T-|T|T-|-E-o|B-B-|oT--M-oMMT-----X-B--M-B-MTo----E-|-EoT-o--T-BEf
-|T---o--|----XoM-X-?M-??-Mo---?oT-?--MM?-MET--oT-BBMBE-EM----T--X-?-ETX--E|--M-?X-o--T-MM-E|M-B-X-E--EE----o-E--M--?M--ETT-Mo--------XE-BT-M-B--B?M--T-|Xo---oMoBE-T---?-TT--BBo-ME-|--E-?oMXX-T----EXf
-XE---o----X-?EoM--TB?-XM-TEX-o?MT--X-Bo|-|-Bo--B-X-oo--X|---oB--|-MM-TMT--X--oX?--?--X-XM--|X-X-M-M--T|B-E-|-B-M---?---Xo|--T-B--ME-EM-T-TXT-E-oEE---|-XTX--E-E-oB-E-----?M-M-M?MMB-T--T-oM|T--|-o--T-f
-?o---E-BX?|-EMX|----?-X-|EB--X-XoBo--B-T-||-E-E--BBTMM-|X---EB--E??oBXEo-BX--BMB|----o--B-TT|-X-?-T--X-o-|-M-B-|E--?|--?B?-Mo-X---B--|---|XT-?--B?-BTT--B?--EM-BX-BX---X--o-T--??---X-EE-M-BET-M-oo-Tof
-BT---?--oM|-||BB-|-?E-BoBT|o-oooMMMo-E-?-?MBT-Xo-M?-Eo--X---B---|ET-M?-T-??--??XX-X?---o?-?E--T-o-X--X-X-B-oo|-E----M--?-E-|--|--|M--Xo-BTo--X-|?-?o-T-BMM--B|BTTo-B---?-|T----|M?-E|--B-?B||-E---T-X?f
m-o-X-M--M-E-o|EX-|TT---ME|T|--??EMM|-X?|-BM|T-EM-Eo-X|-|T---oE-XTBMT-B-E-o---BEEM---XE-Bo---TXTE|-o--MXE-o-TM?-EX---?--XB--|X----T---X|-B-o|-X-oXX-?-T-BTT--XMEBXE-----o-E|-|MT?T||-o----?T|-o-oXMBXE-X
XXXX-XXXXXXXXXXXXXXXXXXXXXXXXXXXXXXXXX-XXXXXXXXXXXXXXXXXX-XXXXXX-X-XX-XXXXX-XXXXXXX-X-XXXXXXXX-XXXXXXXXXXXXXXXXXXXXXXX-X-XXXX-XXXXXXXXXXX-XXXX-XXXXXXXXXXXXXX-XXX-XXoXXXXXXXXXXXXXXXXXXXXXXXXXXXX-XX-XXX
