B----------------------------------------------------------------------X---------------------------BMB-------------------------------------------------------------------------------------------------X
?----------------------------------------------------------------------?---------------------------T-|M------------------------------------------------------------------------------------------------E
|----------------------------------------------------------------------M---------------------------E-oT-------------------------------------------------?----------------------------------------------|
X----------------------------------------------------------------------E---------------------------M||?------------------------------------------------------------------------------------------------X
|--------------------------------------------------------------------------------------------------BBMM------------------------------------------------------------------------------------------------X
M-----------------------------------------------------------------------?--------------------------|oM-?-----------------------------------------------------------------------------------------------E
B----------------------------------------------------------------------X---------------------------?-?|------------------------------------------------------------------------------------------------?
o------------------X--------------B------------------------------------?---------------------------XT-o------------------------------------------------------------------------------------------------v
-----------------------------------------------------------------------M-------------------E-------TM|X------------------------------------------------------------------------------------------------?
B---------------------------------------------------------------------T----------------------------M|||------------------------------------------------------------------------------------------------T
T--------------------------------------------------------------------------------------------------T-ET------------------------------------------------------------------------------------------------X
T-B--------------------------------------------------------------------o----------------------------T?T------------------------------------------------------------------------------------------------X
-----------------------------------------------------------------------E---------------------------||-E-----------------------------B----------X-------------------------------------------------------o
o----------------------------------------------------------------------?---------------------------EXB-------------------------------------------------------------------------------------------------o
m------------------X------------X--------------------------------------B------X-------------X------XB-T---------------------------------------X--------X--------------X------------X-----------------XXX
XX-XXXXXXX--XXXXXXX-XXXXXXXXXXXX-XXXXXXXXXXXXXXXXXXXXXXX--XXXXXXXXXXXXXXXXXXXX-XXXXXXXXXXXXX-XXXXXXXXX-XXXXXXXXXXXX-XXXXXXXXXXXXXXXXXX-XXXXXXX-XXXXX-XX-XXX-XXXXXXXXXXX-XXXXXXXXXXX-XXXXXXXXXXXXXXXXX--X
