EE|-B-oM-??-E?ME?---T-B-M-Bo--|X|X?-MXEB--E----MT-o|EoBXoT-TM-E-E-B-|---MMoE-?-X-T-B-?--TM-?XM-BX|EX-----oBM---X?-X?o?M-?Eo-|?EBE-?-T-|MT?|TTM-X-|B-MMTB--X|?-o-o---B?-|--|-T-o|?|-oXBE-oBE-E?TXE--T|Bo|
MBMo|-XX-X|--B?E----o-?o-BBoB-MB-BB-MTX||-M-|E-E|-M|EE|MoX-?|-X-?-o-----?T-oXX-T-?-|-?-o||TTTX-X|oMM-----?MX-E--T-|oM?XXB?MBBM?|M-X-B|||EEXoEo-|-MoE-B|M--oTXTMTX|--|B|X--X-|---oo-BBMX-?-B|X|MB|--oBX||
XMXo|-Mo--E-?--TB---|-X--o?oo-|B?XT-|X|E|-T-oX-BX-X????X-|-X?---B-X-X---?MTT-|-M-|-o-|--o|o|M--?-MB|o-----Eo-|--X-TETXB||oTMTEEEX-|-BXoXTXBBX|-T-TXoXBoE---TEEXMTM--M-?M--?-EEoMEM-ME-?-||o|ToMBE--EXE-T
EX|-E-X|-Xo-EoTMX---|-XoBMEMX-BXE|E-TXE?T-|-M|-o|-XTTXBTXM-|E-B-?-T-----E?BE|X-?---?-E-XE--E|B-EMTT-o----oMX-?-TE-?|TE|B-|-X-|oEE-T-TETM|XoBTo-M-|-X?|BE----TTXMBo--XMTM--T-|X-|?M-TM-?-?X?EM|B?o--XX?ET
TMBTX-|B--M-??|Xo---E-M-|ET---M-?o--X|?X?-T-TT--X-X?M?TM??-To-?-|-?-|---BEBo?E-E-|-B-T-o?|-oTo-oEBEXM----XX?-B-?o-MEMTTB|X-TEoEoX-T-X?|E?EX-ME-T--X|ETXB--oXo?MToE--o?E|--M-M---M--T-To-|BoX?BT|o--?|X??
BXB-|-ME-|B-?--BE---B-ooXXXoM-TEXXT--??-B-|-MM-oX-XT|TT?BX-M|-M-T-X-B---MBBMT?-B-?-B-?-|-T?|BM-E-XET|-----Mo-|-oX-ToT?oTM-|MBTo?--T-oEBM|M?EX|-T-E?|ME|T--M-XMT|oo--M|MT----EX-MoT-EMEo--oM?X?oTB--EXo?X
o|M|T-?B-o|-XEBBX---E-o|B|ME|-?||Bo-MTToX-?--X-?X-XBX|-|?X-B--E---o-X---MMMoXT-o-o---?-ET?X?Bo-B|o|B?----X?X-B-E|-M|?X|XXB?T?BB||-T-X?-?-|T?|o-X-Eo|M-?T--T?|TXBBE--MT|---|-???XXX-Mo|?-T?EEEX|E?--BXBTX
X|XB--TT----E|BBo---?-EBT-E??-|MEX|-||?X--B-oB-EE-??o-MooT-EB-M-E-T-M---|B?|BT-?-M-X-|-|E-||E?--E-TTB----BTE-?-BT-E-oM-XM-M?-TB|M-o-oMMT|M-oTM-M-oBooEMB--o-BETooE---?T-----TMTT?o-M?EX-|-X??B|BX--??oEv
|BEX?--X-o?-||X|B---X-|X?BBE--MTBoT--TBoB-o-TX-TM-BM-E?T?M-B?-o-?-M-B---||MBBM-X-o-o-X-BX|M|-M-?MM?||----BoB-T-E--XBTM-?|X-BoBET?-|--B-oT?--XM-B-oo|BE|B--?ME|X-o|--T?-X----||MXoo-TEoo-|TEXXo|B|--BEEXM
EoXB|-|X-??--oXMX-----BMTM|M?-??M|M---MBX-?-B?-X--B-?M|T-B-XX-|-X-|-X---Eo-T-X-X-B-?-X-MMoEX?|-BE|-?T----E-?---??-Bo?EME-??X?XB-|-|-EX--o?|XoE-X-XBEM?BM---EBoXEMT--?|XT----|o||-|--XX--??T?MEBTX--B--?T
?TTEE-EX-?|--o|X|---E--BMo?M|-E-M-X-M-ooB-E-T?-B----Bo|TBT-|B-M---o-T---X-|?MM-B---B-B--B-oX||-?XTET?----XXM-o-EM---MM--BEX?TB?To-?-To-oXM?B-?-?--oooBTo--|oTEM--M--|E-|--B-oMTE-T-TEXE-To-TXoMoB--X?--T
X|o??-oB-B?---TX?---o-|M|-To--M-?o?-?o?Eo-|-E|-To-?|o-oEXE-XX-o-B-o-E---XMMoET---M-B-B-EXXMB-E-?oXXT|----oo?-X-?--MEX|M-B-XT?MoE|-M--?|??EEToB-M-EX|B-M----oX?TX?T--MBBo--T-EEXB-E-|T?B-E|-MM-EB---||oo?
X?MX?-|X-E|-EoE-|---o-ET-EoTT-?B|Bo-?T||o-M-E--|X--MBooBoX-||-B---X-|---T|BM-?-?-|-E-X-??oBoB|-??EBB-----E?|-E-??--E-XMT?oEE|XXBT-E-|TX-EMTX?T-E-oT-MMo---o??--E?B--Eo-|--B-To|?T|-X?MM-X?XoE||BT---XM?B
?EM|M-TE-Mo-B?oXo---T-XXB-M|---X-|o--?T||----T-T--MTE-|MMo-X|-B---?-E---oTBEBM-T-B-M-T-MXTT-Xo---T|B-----BEB-X--E-Bo?XEM-XBBTo?|--X-T-EoB-XMBT-T-o|oXBE?--XEB|?XB?--?XXM--M-B|BXM|-XTMB-oMMBXoM?E--EBBTX
m|TMB----BM-?TM|E---B--E??TXM-EM?oB-?TB-|-M-T?-?B-||EX|oB--BB-X-|-?-?---X-?-B|-|-X-B-B--X||--B-o?To-o----E|o-T-oB-----?oT?oXB?-X?-E-?B-TXT-?oE-X-oTMMMTB--|?EBEo?|--T?oX--o-?XE?EE-o-XE-M-XBTBM-X--M?o?-
XXXXXXXXXXXXXXXXXXXXXXXXXXXXXXXXXXXXXXXXXXXXXXXXXXXXXXXXXXXXXXXXXXXXXXXXXXXXXXXXXXXXXXXXXXXXXXXXXXXXXXXXXXXXXXXXXXXXXXXXXXXXXXXXXXXXXXXXXXXXXXXXXXXXXXXXXXXXXXXXXXXXXXXXXXXXXXXXXXXXXXXXXXXXXXXXXXXXXXXX
