TXBoEM?o-MoBM|XMXBMTBT---------------------------------------------------------------------------------------------------------------------------------------------------------------------------------X
oBoEo-TT-?T?oM|EXX--XX---------------------------------------------------------------------------------------------------------------------------------------------------------------------------------|
M?TX--MBo?-EM|XMXX?o-T---------------------------------------------------------------------------------------------------------------------------------------------------------------------------------|
|M|X?--o|oXoB-oMEM-E-----------------------------------------------------------------------------------------------------------------------------------------------------------------------------------B
TE?BBXB?X?TEBMBBE-BET|---------------------------------------------------------------------------------------------------------------------------------------------------------------------------------B
o-E?-T|EM|-MXT-XBT-EMB---------------------------------------------------------------------------------------------------------------------------------------------------------------------------------X
MM?ToXE--|||B|EEX-T||X---------------------------------------------------------------------------------------------------------------------------------------------------------------------------------T
E|TBX-EMM?BoT||?XMo?BM---------------------------------------------------------------------------------------------------------------------------------------------------------------------------------v
XTB?oT?M?TM-oE?B?E-M------------------------------------------------------------------------------------------------------------------------------------------------------------------------------------
XEX|-?-MB??oTX?T-E|-E|---------------------------------------------------------------------------------------------------------------------------------------------------------------------------------X
-MT-|MB?|-EToET-|E-?X----------------------------------------------------------------------------------------------------------------------------------------------------------------------------------?
B-|--oMXX-o|?oTEBE-EM|---------------------------------------------------------------------------------------------------------------------------------------------------------------------------------o
EB?TBM-E-E--B?XBo-MB?o---------------------------------------------------------------------------------------------------------------------------------------------------------------------------------?
BB|X|oMMEBBo-BEBXo-EoT---------------------------------------------------------------------------------------------------------------------------------------------------------------------------------?
m?B|-X-|-T|-XEXMB?---?---------X----X----------------------------------------------------------X---------------------------------------X---X-------------------X---------X-----------------------------B
XXXXX-?XXXXXXXXXXXXXXXXXXXXXXXX-XX-X-XX-XXXXXXXXXXXXXXXXXXXXXXXXXXXXXX-XXXXX-XXXXXXX-XXXXX-XXXX-XXXXXXXXXXXXXXXXXXXXXXXXXXXXXXXXXXXXXXX-XXX-XXXXXXXXXXXXXXXXXXX-XXXXXXXXX-XX-XXXX-XXXXXXXXXXXXXXXXXXXXXX
