------------------------------------------------------------------------------------------------------------------------------------------------------------------------------EMMT--oTTo?M?XM--T?XMo-TM-
------------------------------------------------------------------------------------------------------------------------------------------------------------------------------E|XE-EBoTXB-?B?-B|XBXEETE-
------------------------------------------------------------------------------------------------------------------------------------------------------------------------------TBoTXM-MBB-EMoEMEMMoB-XB--
------------------------------------------------------------------------------------------------------------------------------------------------------------------------------oBT-oTB|oBTTT??E|To-TM||?-
------------------------------------------------------------------------------------------------------------------------------------------------------------------------------??-EEo-E-BBBMBoBTEoXo--XE-
------------------------------------------------------------------------------------------------------------------------------------------------------------------------------?-XXTXXB-T-?XoB?T|?EoTEB?-
--------------------------------------------------------------------------------------------------------------------------------------------------------------------------------X??BoBM--T?MBXXE|XTMETX-
------------------------------------------------------------------------------------------------------------------------------------------------------------------------------M?TME-|?oXooB|XTMEo-|?o??v
------------------------------------------------------------------------------------------------------------------------------------------------------------------------------M|----BMMoMXoMoEBXXMBMoMXf
------------------------------------------------------------------------------------------------------------------------------------------------------------------------------oBBBB|BoX?B-MMB-oooXM-XBXf
------------------------------------------------------------------------------------------------------------------------------------------------------------------------------TB-oo-EoB|MET|M|Mo-BBBBE?f
------------------------------------------------------------------------------------------------------------------------------------------------------------------------------ET----TM|XT|Bo?EB|-TX-oTXf
------------------------------------------------------------------------------------------------------------------------------------------------------------------------------B-BoMMEo??-XMT?TMMEMo|Xo|f
------------------------------------------------------------------------------------------------------------------------------------------------------------------------------T-?oEM-T|BTBX|T--XEE?M---f
m-----------------------------------------------------------------------------------------------------------------------------------------------------------------------------TM|o|-MEXTBE-XoB?M|XXT|-XX
XXXXXXXXXXXXXXXXXXXX-XXXXX-XXXXX-XXXXXX-XXXXXXXXXXXXXXXXXXXXXXXX-XXXXXXXXX-XXXXX-XXXXXXXXXXXXXXXXXXXXXXXXXXXXXXXXXXXXXXX-XXXXXXXXXXX-XXX-XX-X-XXXXXXXXXXXX-XXXXXXXXXXXXXXXXX-XXX-XXXXXXXXX-XXXXXXXX-XXXX
