EE---|o-X?-BoBMo-|E?T-E--BBM--X-M-oEM|-ME-E-|--B?--BMo-XB-ETE-EX--BT|o--E-XM-?TXBXEB----??-BX--E-ETT-M--oBBB-E--?MB?o-M-?o-M|MET-X?-|MoMT-E-T-ooMM--MMXB--X??-o-MM-oo|oB---TT|-??|Xo-|ETE-?-ETT??--||B-|
MB---XX-Eo--T|?|-?-Bo-BoBBBEB---?XBMMX-?X-M-X---?--|MEoME--?M-XX--oX-X--?-TEXXTTo-E|---o??T?T--T||ET-o--MTMT-E-BX-ToM-XXBBXXBM?--?X??MM?E-X-E-E-EEBE?BBM--MX-TMTE|-E---oT-T||M-Too?X-BXoT-o|X|MMoo-MBXT|
XM-T-|M-T--T-o-o-oTB|-X-E|??o---|oEo|T-E?-T-X--oX--?X?|XT-TXT--X--XXXB--oT-M-|BM-M|o----oBo?M--X-XT--|--T-E|-E-??-MET-B||o|oTMET-E|TT?|oT-|-X-B|oo-ooB-E---XoEXM?T-|-oMTT-E-E?-MEMXX-X?-X-o|T|MBT?-EXETT
EX-T-?X--T--?BTT-oMo|-Mo-XE?X-B-B?BXTM-XT-|-B--?----EX|To-||?-BX--To----Eooo|XX??TB?---X?B-||--|||To-E--XBM?-|-|-MM|T-|B-MEB-?oM-XTTE??B|-X-T-X-MBTXM||E---?MTXMT?-BMBEB|-oM|B-|?MMM-o?XX-oEM-Bo|T-EX??T
TM-B-B|-|--MTE|E-BX-E-?-EMTX----E-ooXT-||-T-T--TE---T?-MM-|TM-?---?X|---|M|E?EBE-E?B---oXB-|T--EXM?o-E--B-X|-M-BE--EM-TB|T-BEXET-MTEo-MB?-T-M-|XMEo|MT|B--o-E?MTE?-|MXBM|-X-M|-?M-TB-oo|--MX?|ToX--M|XX?
BX-E-BM-T--BX?-E-X?-B-?oM|X|M-?-T-oX---oX-|-E--??---MTX?T-|M?-MT--XoBT--|M?TT?EB--XB---|?B?TB--ET-Bo----E-ME-M--oMEoT-oTME?oB|oB-?T|BoTM|-M-X-B-|oT||EoT--|TTMT|M|-o-?o?T-ETE|-ToTBB-BoB--|?XToo?E-TXo|X
o|-B-M?-|?-TXoBT-|oXE--|oTME|---?BTMM--MM-?-X--oT--Eo|||M-MBB-EB--o-Xo--BoBBXT-o?-B----ETMXTB--o|TB-----o??M-T-?|oT|?-|XX?--?EBM-MTM?o?M--B-|-|EBXo|M-TT--??oTXB|--|-?|M?-???T-MXX|B-|?X--XEEo|BX|-EXBMX
X|-o-oT-XX-XT-B|--MT?--BXME??-o-T?T||o-XM-B-M--?T--EX-?o--|E--M|--TMMo--BETMBTo?EM-X---|oT|BE--EoE|X-?--B|TM-M-?MBE-o--XMoo--EBE-XoMM||-|-o-T-MET-|o?EBB--ToTEToM--TTM-XX-EoTB-X?o-X-XXM?-|??E|E?--X?o|v
|B---E--B--EBEXB-MEMX-MX-|BM--X-B-?o-?-|M-o-X--EB--MXEoTE-XBM-o---M?B|--E??EBM-X-B?o---BEBMT---|XoBT-B--TEoT-X--|T?BT--?|-TTo?Eo-||?XBMTT-?-X-|E-Eo|?EEB--oT?|X-XX-B?XE-|-?|||-EooE--MoE|-oXX-|-XE-|EEoM
Eo-|-B|-ME-EE?X?-B?X---MEM||?-X-M-BX-E-?--?-?--|o---XM|TM-TXB-|X--|oXT--X|B|-X|X||??---MX-EX?--X-MBB----BT-T-B-EBXoo?-ME-XMX?|B---|TT??-o-M-o-E|MMBEB?EM--?MBoXE|T-M-BEoE-oB|?-|-|TE-o-?--|?M|B|-|-o--?T
?T---|E-M--oX-|E-MT-E-MBXo?M|-M-?|B?MB-|o-E-B---o--E|oBT--?||-MX--o-T?--ooMXMM|BB|-B----EXoo|--TXT||-E--XXXo---EBo--M---BE-TTE??-B?XB?oEX-X---BX-MXoMB?o--XTEEM-Mo-TB|XEX--MoM-?-T-o-EE---?TXoM-o--M?--T
X|-T-Mo-TX-oE-TB-|MEo-oMMXTE--|--oXB??-TT-|-?--XM--BT-oE?-?XX-oB--oTEM--|ToBETX-BBXB---E?oMB---MMoET----TooE---X|M|EX-M-B-XX?Moo-XME--???-|-o-|?MTX|E-o---?MT?TXXE--M??B|-?XEM-M-E?o-?BB?-oMMXE??B-B|o|?
X?-M-T|-|?-o|-E--X?To-TTMBoTT-o-ToMX?M-TX-M-M--TT--oXoXBM-M|T-Bo--X-||--MT?X-?M?-MBE---?B?BBB--M-?oE-E--TE?T-o-BTB?E--MT?M|B|TXB-TE|oM|BE-B-?-oT?XT-EM|---|MX--EBE-o?BT|E-MBT|-oT|oB--M?o--oET|XXX-BXM?B
?E-|-oT-?X-?oooE-METT-XXo-MX--?-XET----E----|--M?--T|-|MM-EX|-B|--?oEX--TME|BMoTBEBM---Mo-T-X--XXX|M-E---ME--E--B??o?-EM-B-BTo?|-EX|X|M|B-T-B-||XBBo|BT?--ET-|?XBB--TXE?E-TEB?-|M|B|-XBBX-XBX?MXoE--BB-X
m|-E-E--BE-E--MT-MXoB-?E|MTMM-|-XE|B?|-|--M-X--BT--oTXMoT-MBX-XX--?|?|--TM?EB|?|MEoB----?E|E---?EooE----TX|X-?-XoEE---?oTXXMBE---oEB?BBXX---o-TToooMXM?B---X|BEoo--MoTT?M-ET?o-?EE-o--EX--MBT?MMBE-o?oX-
XXXXXXXXXXXXXXXXXXXXXXXXXXXXXXXXXXXXXXXXXXXXXXXXXXXXXXXXXXXXXXXXXXXXXXXXXXXXXXXXXXXXXXXXXXXXXXXXXXXXXXXXXXXXXXXXXXXXXXXXXXXXXXXXXXXXXXXXXXXXXXXXXXXXXXXXXXXXXXXXXXXXXXXXXXXXXXXXXXXXXXXXXXXXXXXXXXXXXXXX
