----E-X------------E-----ME------------------Bo-----------o?-----------------B--------------MM--------B----------------MMo---E------M----B-------------M----------M-E-----------------------Xo-------E-E
|------------------------------------B?-------E-?XB---------X----B---------X--------E-------------X-------------B---------------M-M-----X-----------------------M---------------------------MEE--X----EB
B-o-----------------o---------------------X---------------?--M--------------o---------X-X----------------?-------B-----------------------XE-------M--?---X------?----------?-------E------------------MX
T-------------------X-------B----------M--o---MM-----------X-B--------o---o---E-----M---------?-----------M---oM--------X-----X-E--------------------------------------E----------------------------M-TB
Eo---E----------------------------------------------------------X----E----------------M-EX------?-------------E----B--------M----------?----------------B----XX---------X------E---o------M-oE-X---o--XX
oo------------------B-------------XE-X------------------X-M------------------M-o-----?-----------------------X------------------------------?-?----------------X-------------------B------------------XE
X?-----B---------M---------------?--B----X---------------------------B-------------E----?------------------X----------------------E-------o-o---E?-------------------------------------?--X------o-----|
M---------------B---X--?----------------------------------------------------------M-----?-------M---B--------------E--X---M--------X--------o-XB------E-------------------------------X---?--X-E-B----?v
?-----------------E-------------------?---------------o--------o-----M----------------------------------X---E--X--------------------?---X------------------?---------M-------------X------------------BT
o----?---------------?----------------B-B---E----------------------------?------------BX------------------------------------o?--E-----------X------------E--------------------------------------------TX
B-----M---------------EX--o------------------------------------------------------------MM----------------------M--------------------------------------B-X--------E-----------------M-----E---------X--E?
?---?----?------E---B--------------------X---o-----------B--o------------------BE--------E----------------o------?-?----------X----------------------------------B--E--?------X-----------------o----Xoo
M----------M--------E---X----------X------------------o---E---o----------?----X--E-----M----------Bo------------B---------------------------------------?-------o-E--------------o-E---?-o-----E-BB--T-X
oX-------------EB--X-E--M--X-------------------------------------o--------------------B-----BE-------M--------------M---------M-----------X-o---------------------------E-----------------------------BX
mX-------------------------o---------XE---X---B--X-B------X---------------------------?--------X--B------EM-------XX-------------X--X---X----------E---B------X-----X------------------o-----B-----B-X|o
X-XXXXXXXXXXXXXXXXX-XXXXXXXXX-XXXXXX--XXXX-XXXXXX-XXX-XXXX-XXXXXXXXXXXXXXX-XXXXXXXXXXXXX-XXX-XX-XXXXXXXXXXXX-XXXXX-XXXXXXXXXXXXXX-XX-XXX-XXXXXXXXXXXXXXXXXXXXX-XXXXX?XXX-XXXXXXXXXXXXXXXXXXX-XXXXXXXX-XX
