----E---M----------------M---------E---------------B-------?---M---------X------------------M--------------------------MMo----------M----B-------------M----------M-E--------------X---------o----E--E-E
|-----------o-----EM----------------MB--oB----E--X-------------------------X-E--?---E---------------------------BM--------------M-M-----X---------------E-------M----------------o------------E--X----EB
B-o-----------------o---------------------X---------------?-----------------o--------M-------------E-------------B-----------------------X--------M--?-------E--?-------------------------------------MX
T-o-------------------------B-----------M-----MM----B------X-B---o--------o--E------oM--------------EM--------oM--------X-----X--------M-------------------------------E--------------E-------------M?TB
E----E----------B-----------------------------E--------------o------oE-----------------------------X----------E----B-----------------------------------oB---------------X-------E--o--------o-BX------XX
oo-----E------------B-?-----B------E----------------------M--------------------------?-----------------------X----------------------------B-?-?----------------X-----X--E-?--------B-----------------MXE
X?-----B----------X--------------?o------X------------------X-------?-----B--------------------------------X----------------------E-------o-o----?-----------------------------------o-?---------------|
M---------------B--------------------------------E-M---------------EX---B-X-------M--E--------------B--------------E--X---M--------X--------o-XB------E------------------------------B---?-----E------?v
?-------------B---E-------------------X---------------o--------o----------------------------------------X---E--X-------------------------------------------?---------M--X----------X------------------BT
o----?---------------?----------------------E----------------------------?-----oE?-----X--E?--------------------------------o?--E-----------X-------B--------------X----------------------------------TX
B-----M----------------X------------B----------------------------X------------------------------------B--------M------------------------------------X-B-X--------E----------------------------E-------E?
?X--?----?----M-----B-------E----M-----------------E---------------------------B---------B-----B----------oB-----?-?----------X---------?---o--?-----------------B--E--?------X--------------------E--oo
M----------X------B-E---------------------------------o--------------B-----X--X--E-----M--------B-B-o-----------B---------------------------M---------o-?-------o-E--------------o-E-----o-------BB--T-X
o---------------X------------------------------o-----------------o----?---------------B-----B-------EB--------------M---------M-----------X-o---------------------------E----------------------?-E----BX
mX---------XMo-------------o---------XE---X-M-B--X-------------X---------B---------X--?--------X------------------XX-B----E----?-X--X----X---------E---B------X-----X------------------o----------E---|o
X-XXXXXXXXX-XXXXXXXXXXXXXXXXXXXXXXXX-XXXXX-XXXXXX-X-XXXXXXXXXXX-XXXX-XXXXXXXXXXXXXX-XXX-XX-X-XXMXXXXXXXXXXXX-XXXXX-XXXXXXXXXXXXXX-XX-XXX-XXX-XXXXXXXXXXXXXXXXX-XXXXX?XXX-XXXXXXXXXXXXXXXXXXX-XXX-XXXXXXX
