--------------------------------------------------------------------------------------TB|oT-|?XX|B------------T-----------|-----------------------------------------------------------------------------
--------------------------------------------------------------------------------------?oETBXB|?Eo------------?|-----------T-----------------------------------------------------------------------------
----------------------------------------------------------------------------------------oE||M-o-MM----------TXB-----------?-----------------------------------------------------------------------------
--------------------------------------------------------------------------------------BM--o||X|EXB------------------------?-----------------------------------------------------------------------------
--------------------------------------------------------------------------------------?-Mo?MBXMMTM-----------ME-----------|-----------------------------------------------------------------------------
--------------------------------------------------------------------------------------BEM-|--M-X|------------XT-----------E-----------------------------------------------------------------------------
--------------------------------------------------------------------------------------T|-MoMXE|XoB-----------XE-----------?-----------------------------------------------------------------------------
--------------------------------------------------------------------------------------oT??B-EBE-EX-----------TE-----------M----------------------------------------------------------------------------v
--------------------------------------------------------------------------------------E--|BMMXETo------------M?----------------------------------------------------------------------------------------f
--------------------------------------------------------------------------------------|XE--?--TM|o-----------?B-----------X----------------------------------------------------------------------------f
----------------------------------------------------------------------------------------|X-|XEToB?-----------ET-----------o----------------------------------------------------------------------------f
---------------------------------------------------------------------------------------BXoEET--BTE-----------oE----------------------------------------------------------------------------------------f
--------------------------------------------------------------------------------------B|MT-BE-o-X|-----------Bo-----------E----------------------------------------------------------------------------f
--------------------------------------------------------------------------------------oM-|TBE--|oX-----------M|-----------T----------------------------------------------------------------------------f
m-----------X------X-------------------------------X--------------------X-------------T-B-o-BoBX-T----X-X----EE-----------o------------X----------------------X--X--------X--X--------------X----------X
XXXXXXXXXXX--XXXXXX-XXXXXXXXXXXXXXXXXXXXXXXXXXXXX-X-XXXXXXXXXXXXXXXXXXXX--XXXXXXXXXXXXXXXXXXXXXXXXXXXX-X-XXXXXXXXXXXXXXXXXXXXXXXXXXX-XX-XXXX-XXXXXXXXXXXXXXXXX-XX-XXXXXXXX-XX-XXXXXXXXXXXXXX-XXXXXXXXX-X
