--------------------------------------------------------------------------------------------------------------------------------------------------------------------------------------------------XMEE|-
--------------------------------------------------------------------------------------------------------------------------------------------------------------------------------------------------T?-X?-
--------------------------------------------------------------------------------------------------------------------------------------------------------------------------------------------------X?o-M-
----------------------------------------------------------------------------------------------------------------------------------------------------------------------------------------------------|oM-
--------------------------------------------------------------------------------------------------------------------------------------------------------------------------------------------------oBEEo-
---------------------------------------------------------------------------------------------------------------------------------------------------------------------------------------------------oX|E-
--------------------------------------------------------------------------------------------------------------------------------------------------------------------------------------------------T-o|X-
--------------------------------------------------------------------------------------------------------------------------------------------------------------------------------------------------E??B-v
--------------------------------------------------------------------------------------------------------------------------------------------------------------------------------------------------|X|-Mf
--------------------------------------------------------------------------------------------------------------------------------------------------------------------------------------------------BoEXXf
--------------------------------------------------------------------------------------------------------------------------------------------------------------------------------------------------MoEBMf
--------------------------------------------------------------------------------------------------------------------------------------------------------------------------------------------------?BM?Mf
--------------------------------------------------------------------------------------------------------------------------------------------------------------------------------------------------TTXM-f
--------------------------------------------------------------------------------------------------------------------------------------------------------------------------------------------------EoBTXf
m-----------------------------------------------------------------------------------------------------X------------X------------------------------------------------------------------X-----------X-?MMX
XXXXXXXXXXXXXXXXXXXXXXXXXXXXXXXXXXXXXXXXXXXXXXXXXXXXXXXXXXXXX-XXXXXXXXXXXXXXXXX-XXXXXXXXXXXXXXXXXXXXXX-XXXXXXXXXXXX-XXXXXXXXXXXXXXXXXXXXXXXXXXXXXXXXXXXXXXXXXXXXXXXXXXXXXXXXXXXXXXXXXX-XXXXXXXXXXX-XXXXX
