--------------------------------------------------------------------------------------------------------------------------------------------------------------------------------------------------------
--------------------------------------------------------------------------------------------------------------------------------------------------------------------------------------------------------
--------------------------------------------------------------------------------------------------------------------------------------------------B-----------------------------------------------------
--------------------------------------------------------------------------------------------------------------------------------------------------------------------------------------------------------
--------------------------------------------------------------------------------------------------------------------------------------------------------------------------------------------------------
-----------------------------------------------------------------------------------------------------------------------------------XXXXXXXX-------------------------------------------------------------
----------------------------------------------------------------------------------------------------------------------------------------------------------------------------------------------------X---
------------------------------------------------------------------------------------------------------------M------------------------------------------------------------------------------------------v
-------------------------------------------------------------------------------------------------------------------------------------------------------------------------------------------------------f
-------------------------------------------------------------------------------------------------------------------------------------------------------------------------------------------------------f
--------------------------------------------------o--------------------------------------------------------------------------------------------------------------T-------------------------------------f
---------------------------------------------------X-----------------------------------------------------------------------------------------------------------??|???----------------------------------f
--------------------------------------------------XX-------------------------------------------------------------?-----------------------------------------------|-------------------------------------f
------------------BBBBB--------------------------XXX-------------------------------------------------------------------------------------------------------------|-------------------------------------f
m-----------------------------------------------XXXX---------------------------------------------------E-------------------E-------------------------------------|-------------------------------------X
XXXXXXXXXXXXXXXXXXXXXXXXXXXXXXXXXXXXXXXXXXXXXXXXXXXXXXXXXXXXXXXXXXXXXXXXXXXXXXXXXXXXXXXXXXXXXXXXXXXXXXXXXXXXXXXXXXXXXXXXXXXXXXXXXXXXXXXXXXXXXXXXXXXXXXXXXXXXX---X|XXXXXXXXXXXXXXXXXXXXXXXXXXXXXXXXXXXXXX
