----E-X------------E-----ME-------------------o-----------o?----------?----------------------M-------------------------MMo----------M----B-------------M-----E----M-E-------------X----------o-------E-E
|------------------------------------B--------E-?XB---------X--------------X----?---E---------------------------BM--------------M-M-----X-----------------------M----------------o------------E--X----EB
B-o-----------------o-------------------E-X----------B----?-----------------o--------M-------------E-------------B-----------------------X--------M--?-------E--?--------------------------------o----MX
T---------------------------B----------M------MM-----------X-B------------o--E------oM--------------EM--------oM--------X-----X----------------------------------------E--------------E-------------M-TB
EE---E--------------------------------------------------------------oE-----------------------------X-o--------E----B----------------------------------o-B-----------?---X-------E--o--------o-BX------XX
ooX----------------BB-------------XE-X------------------X-M--------------------------?-----------------------X------------------------------?-?----------------X-------------------B------------------XE
X?-----B---------M---------------?-E-----X---------------o----------------B--------------------------------X----------------------E-------o-o----?-----------------?-----------------o-?--------o------|
M---------------B---------E----------------------------------------EX---B-X-------M--E--------------B--------------E--X-E-M--------X----E---o-XB------E----------------------------------?-----E------?v
?----o------------E-------------------?---------------o--------o---------------------E------------------X---E--X-------------B-----------------------------?---------M------------X-------------------BT
o----?---------------?----------B-----B-----E----------------------------?--E----------X--E?--------------------------------o?--E-----------X-------B----------------------------------------------M--TX
B-----M---------------EX---------------------------------------------------------------o--------------B--------M------E-----------------------------X-B-X--------E----------------------------E-------E?
?---?----?------E---B--------------------X---o---------------------------------B---------B-----B----------oB-----?-?----------X----------------------------------B--E--?------X-------------------X--Boo
M-o-----------------E---X------E---X------------------o---E---o------B--------X--E-----M--------B-B-------------B------------------------------------Mo-?-------o-E--------------o-E-----o-------BB---TX
o--------------E--------M----------------------------------------o----?---------------B-----B-------EB--------------M---------M-----------X-o---------------------------E----B-------------------E----BX
mX-------------------------o---------XE---X---B--X-----------o-X---------B---------X--?--------X------------------XX-B---------?-X--X---X----------E---B------X-----X---------M--------o-----------B--|o
X-XXXXXXXXXXXXXXXXX-XXXXXXXXX-XXXXXX--XXXX-XXXXXX-XXXXXXXXXXXXX-XXXX-XXXXXXXXXXXXXX-XXXX-XXX-XX-XXXXXX-XXXXX-XXXXX-XXXXXXXXXXXXXX-XX-XXX-XXX-XXXXXXXXXXXXXXXXX-XXXXX?XXXX-XXXXXXXXXXXXXXXXXX-XXX-XXXXXXX
