--------------------------------------------------------------------------------------------------------------------------------------------------------------------------------------------------------
--------------------------------------------------------------------------------------------------------------------------------------------------------------------------------------------------------
--------------------------------------------------------------------------------------------------------------------------------------------------------------------------------------------------------
--------------------------------------------------------------------------------------------------------------------------------------------------------------------------------------------------------
--------------------------------------------------------------------------------------------------------------------------------------------------------------------------------------------------------
--------------------------------------------------------------------------------------------------------------------------------------------------------------------------------------------------------
--------------------------------------------------------------------------------------------------------------------------------------------------------------------------------------------------------
-------------------------------------------------------------------------------------------------------------------------------------------------------------------------------------------------------v
-------------------------------------------------------------------------------------------------------------------------------------------------------------------------------------------------------f
-------------------------------------------------------------------------------------------------------------------------------------------------------------------------------------------------------f
-------------------------------------------------------------------------------------------------------------------------------------------------------------------------------------------------------f
-------------------------------------------------------------------------------------------------------------------------------------------------------------------------------------------------------f
-------------------------------------------------------------------------------------------------------------------------------------------------------------------------------------------------------f
-------------------------------------------------------------------------------------------------------------------------------------------------------------------------------------------------------f
m--X---X---------X-X-----------X--X--X---------------------X-------X------XX-----------X-----X----------X------------X---------X-------X---------------------------------------------------------------X
XX--XXX-XX-XXXXX--X-XXXXXXXX-X--XX-XX-XX-XXXXXXXXXXXX-XXXXX-XXXXXXX-XXXXXX--XXXX-XXX-XX-X-XXX-XXXXXXXXXX-XX-XXX-XXXXX-X-XX-XX-X--XXXXXX-X-XXXXXXXXXXXXX-XXXX-XXXX-XXX-XXXXXXXXXXX-XXXXXXXXXXXXXXXXXXXXXX
