----E--------------------M---------E-----------------------?--------------------------------M--------------------------MMo---E------M----B-------------M----------M-E---------------?-------Xo-------E-E
|-------B---o------M----------------MB--o------E-X-------------------------X-E--?---E---------------------------B-M----------X--M-M-----X-----------------------M---------------------------MEE--X----EB
B-o-----------------o---------------------X---------------?-----------------o--------M---------------------------B-----------------------X--------M--?----------?-----------?-------------------------MX
T-o-------------------------B-M--------M------MM-----------X-B---o--------o--E------oM--------------EM------E-oM--------X-----X----------------------------o-----------E----------------------------M-TB
E----E----------B-B---------------------------E--------------o------oE-----------------------------X----------E----B-------o---------------------------------XX---------X------E---o------M-oE-X---o--XX
oo-----E-----------XB-?-----B------E----------------------M--------------------------?-----------------------X----X------------------X------?B?----------------X-------------------B------------------XE
X?-----B----------X--------------?o------X------------------X-------?-----B--------------------------------X----------------------E-------o-o----?---?---------------------------------?--X------------|
M---------------B--------------------------------E-M---------------EX---B-X-------M--E--------------B--------------E--X---M--------X--------o-XB------E-----------------------------------?--X-E------?v
?-------------B---E-------------------X---------------o--------o---------------------X-----X------------X---E--X------------X------------------------------?--------EM-------------X------------------BT
o----?---------------?----------------------E----------------------------?------E?-----X--E?--------------------------------o?--E-----------X---------------------------------------------------------TX
B-----M----------------X------------B--------------------X-------X-----M---------------------------------------M--------------------------------------B-X--------E-----------------M-----E---------X--E?
?---?----?----M---E-B------------M-----------------E--------------B------------B---------B-----B----------o------?-?----------X----------------------------------B--E--?------X-----------------o-----oo
M-------------------E---------------------------------o--------------B--------X--E-----M--------B-B-------X-----B---------------------------------------?-------o-E--------------o-E---?-o-----E-BB--T-X
o--------------MX------------------------------o-----------M-----o----?---------------B-----B-------E---------------M---------M-----------X-o---------------------------E-----------------------------BX
mX---------XMo-------------o---------XE---X-M-B--X-------------X---------B---------X--?----M---X---------EM-------XX-------------X--X---X----------E---B------X---B-X------------------o-----------B-X|o
X-XXXXXXXXX-XXXXXXXXXXXXXXXXXXXXXXXXX-XXXX-XXXXXX-X-XXXXXXXXXXX-XXX-XXXXXXXXXXXXXXX-XXX-XX-X-XXMXX-XXXXXXXXX-XX-XX-XXXXXXXXXXXXXX-XX-XXX-XXXXXXXXXXXXXXXXXXXXX-XXXXX?XXX-XXXXXXXXXXXXXXXXXXX-XXXXXXXX-XX
