--------------------------------------------------------------------------------------------------------------------------------------------------------------------------------------------------------
--------------------------------------------------------------------------------------------------------------------------------------------------------------------------------------------------------
---------------------------------------------------------------B----------------------------------------------------------------------------------------------------------------------------------------
-----------------------------------------------------------------------------------------------------------------------------------------o----------M---------------------------------------------------
--------------------------------------------------------------------------------------------------------------------------------------------------------------------------------------------------------
--------------------------------------------------------------------------------------------------------------------------------------------------------------------------------------------------------
--------------------------------------------------------------------------------------------------------------------------------------------------------------------------------------------------------
-----------------------------------------------------------------------------------------------------------------------------------------------B-------------------------------------------------------v
------------------------X------------------------------------------------------------------------------------------------------------------------------------------------B-----------------------------f
------------------------------------------------------------------------------------------------------------------------------------------------------------------------------------------------------Bf
-------------------------------------------------------------------------------------------------------------------------------------------------o-----------------------------------------------------f
----B------------------------B--------------------------------------------------------------------------------------------B----------------------------------------------------------------------------f
---------------------------------------------------------------------------------------------------------------------------------------------------------------------------------B---------------------f
-------------------------------M-----------------------------------------------------------------------------------------------------------------------------------------------------------------------f
m------------------------------------------------------------------------B-----------------------------------------------------------------------------------------------------------------------------X
XXXXXXXXXXXXXXXXXXXXXXXXXXXXXXXXXXXXXXXXXXXXXXXXXXXXXXXXXXXXXXXXXXXXXXXXXXXXXXXXXXXXXXXXXXXXXXXXXXXXXXXXXXXXXXXXXXXXXXXXXXXXXXXXXXXXXXXXXXXXXXXXXXXXXXXXXXXXXXXXXXXXXXXXXXXXXXXXXXXXXXXXXXXXXXXXXXXXXXXX
