|-T-?--XX|T--?-MM--X||?XT-o-BM-oB--MB|?-X||MEE-|E-o?To-T-|--TX|-o|oXMXTX--E--oB?TM?o?TE--XEXBE-EB-|o--XBX---|--MM-?-?--oooXEX|MBXEME||-E??o?o--?T-BMo---B|B-M?M-B|--|XBX-BXB---o-ooB-o--T?|XB||T?|o-oM-B
MoT---XB|-EX-X-T-EX-MTEM||M-|BMB-B--BMB-E-MB|E-Eo-|-XoX--?o-MoM-ETBo-E-|--|T-oMX|X-B|-o-?X?T?T--X-M|--|TX-----EBM--TBo-B-B?BMXBTB-E?|M-?|-T-o-T||BTXT-E-|XBoB-T-X?|B---B-ME--B|-E?EM-|-B-|X-BX-T|?o-TT-E
M?X-X---|?---M--oTX--E?-|MXBBM-E||X?BB?---MBT?-|B-|E-BM--BX-??o--?-X--BT--M|-XB-XE-XMBT-MBM???-MX-?B--oX----T|MXo--To--E|M-Mo?-EoB---T---EXMo-T|-T?EX-|-?XT-T?--X-|-T?-o-EX|--B-M|ME-o--|To?--?E|-T-TBXX
?|X-|-EXE-T?-|-B|-oBoXEE|ETM--TXEMBBBTT-T--Eo--|E-|o-T---?--oo-|B?MMMX?---X--o--B-M-XoT-T-EE|B-|M-B---T-EX--BEXoo---BT-EX-|--|-BoXE||-B|XBTXB-oMEEB|T-E-?--T||B--XE-X-XE-E|B-X--?|Bo-M--oXT?X?E-?MM-?-TB
TEM-T-BE|T-B-M-?-BToXo-X-|M?oMo-XX||EXT-E-BXX?--|-M--TM---B-Eo--?-|TETT---|?-B-ToTo-BT?-Mo|EM--|?-BE--XXM----|M-M-o-EM-X-|--o?BB|--TE-|?-|MEM-BMoBo|T----|oET||-MMo-B|?T-XX?-MTo?-X--o--oM-B?o??TT--E?Mo
TTB-?-EBoT|--E-o-|-EX|T-TBBEoBB--M||BMT-M-?ETM|MM--E-X|--M--MX?--TEo--ET--Bo--?|X-EM|o|-M--o|B-X--X?--?|B---EXX-T-|B-X-XX-?-TX|T-?-ToT-?oEMEB-E?-MBEE---|T-X-B--?ME---oB-Xo|-|B|-BT-B---?--|MMM??T--?-BE
ME?-B--|E|MX-T-M?-T-E?-||-EX--|-oXoBM|oXB-T|BB-TE-TB-X?---|-M-o-|TEXTBBB--X|-o?oM|B-T??-M-B|-X-||--B--MoE----?T?o-B-oX-XToMX-E-ET|XoB?E-BMoMT-BEM-oE?-|-EX-M-MX-T-o-MXo|-X-E-|-MX-To-T--EEEM?E-oTE|BX|oT
TTo-|-XEBEEM-o--T|T|T-BT?-MTM|?XEM|B?-T-T-?M?X----|-EM?--?B-M-T-E|ETMBXB--|E-EB?TMBX--T-?T?MTo-XX-----|-o---MTBM-?--oo-oo-oTXoT-EEEBT??-Bo-?M-B-B-BE--o-ME-|BEB-MX?-XT-?-?E--X-X-EBB-M--oEo|B-B|o|B-?-?v
?-|-o-XM-oB|-o-XBE|E-B-|EBEooT-B-o-|TTT-M--ToT-MB-MX-X?--|X-ToX-T-BE-ETB--oM-E?E?MEX|oB-oBXXM?-XM-|o--?XT----XM?|-o-?E-??M--XB|ooX|oM--XEB-|B-ooB|-ooB--E-BXE?---X|-|XBo--|M-M-o|EMB----BM-|BoT|T---|M-?
BE?-o--XB-T|----MB-MTX?-EEXEE-TBXM-E-Bo-?-Eoo--oB--oM?|--?|-M-|-?-T-oETT---T-E|-TETE|-B-?o-?B--|E-ME--TTo---ET|||-B-BT-T|---|-MEEB-X?T?T?M--M-?-E||BT-B--oTBX-E-TMB-B--B-TB|-MBXTMT|-E--BEXTXoT?o|X--TT-
?|B-|-?EEM|E?o-EXoM-|M-??-oo-B-Mo--?-BM-|-MoTE-||-BBT-E--E--?TE-MT-TXB|X--T--MT--X?TXET-oMEE-?-?--|?--Eo----oEEBE-B-TB-XEBoM-BX-TT|B|XooBT?X--?M-M-EX-T-BXB-o-X-TX--o?E--oTM---X?-M|-|--T-?-oXX-T?o--|M-
-XE-B-E-X-|T-|-EooBT??BXMXoET?oBME?oXoB-X-T?BM--|-X---M--XT-oE?-oB-M??oM--MX-XTXM-BTE-X-TM--BB----M|--T-B---E|BT--M-TB-|X|----TBM-BXTT-oBE?o--MEoE----|-T-XEB|E-|MX-E|T?-T?--MX--MMM-T---XX-MT-M|oo||-o?
-?B-E-T?-X?X---?X-M-|?oX---BB?XTX-T|-XB-B-|--o-EX-BB-?E--T-EBoE-MX??-X-E--BX-?XME|M--Eo-B-|-TB-?E--X--Xoo---EBB-E-B-T?-XMXMM-?MX?|MMo-B|XE-?T-o?-oBETTT--B?T--X-EE|B-B?B-T-o-T-?o?-B-E--MXM?TETTMB--|TXo
TB|-M-|X-oM--E-|?XE-|E-BooB||-oo-BM?ooE?X-?TM?-X--M??Mo-E-|-?-T--?ETEXT----?-|??XXX?BX--??T?X|-T|-XT--XTX---T?|---T-XX-X|B|||-B|E--B-B-oT?oM--E|--TX|-T--MM-MX?-BEM-EBTX-E|B---X-M?XEX--oX?TT|-|E?B-o-o|
m-M-M--o|M-?-T-TMEX|?---TM-T-|-MXoM?|X--B-Bo|E-E--Eo?M|--B--||--?EBM-M|---T?-EXEEM-EMXE-EoX-TE-EM-M|--M|E---BE?|--E-EE-??E|-|X?-BX-BBEoo?-MX--X-o?XMo-T-?T|E||?-|-o-B|||-BEE-|METT|X-X--B|?X|-oXoXE-TX-?
XXXXXXXXXXXoXXXXXXXXXXXXX-XXXXXX-XXXXX-XXXXXXXXXXX-XXXXXXXXXXXXXXX-XXXXXXXXXXXXXXXXXXXXXXXXXXXXXXXXXXXXXXXXXXXXXXXXXXX-XXXXXXXXXXXXXXXX-XXX-XX-XXX-XXXXXXXXX-XXX-XXXXXXXXXXXXXXXXXXXX-XXXXXXXXXXXXXXXXXX
