--------------------------BBBBBB-------------------------------------------------------------------XXX--------------------------------------------------------------------------------------------------
----------------------------------------M-------M-------------------------------------------------------------------------------------------------------------------------------------------------------
--------------------------------------------------------------------------------------------------------------------------------------------------------------------------------------------------------
--------------------------------------------------------------------------------------------------------------------------------------------------------------------------------------------------------
---------------------------??---------------------------------------------------------------------------------------------------------------------------------------------------------------------------
--------------------------------------------------------------------------------------------------------------------------------------------------------------------------------------------------------
--------------------------------------------------------------------------------------------------------------------------------------------------------------------------------------------------------
------------------------------------------------------------------------------------------------------------------------------------X------------------------------------------------------------------v
-------------------------o---------------------------------------------------------------------------------------------------------XX------------------------------------------------------------------f
----------------------------------------------------------------------------------------------------------------------------------XXX------------------------------------------------------------------f
---------------------------------------------------------------------------------------------------------------------------------XXXX------------------------------------------------------------------f
-----------o--------------------------------------------------------------------------------------------------------------------XXXXX------------------------------------------------------------------f
--------------------------------------------------------------------------------------------------X----------------------------XXXXXX----------------------------------------------------------------T-f
------------------------------------------------------------------------------------------------------------------------------XXXXXXX----------------------------------------------------------------|-f
m---------------X-----E------------------------------------------------------------------------------------------------------XXXXXXXX----------------------------------------------------------------|-X
XXXXXXXXXXXXXXXXXXXXXXXXXXXXXXXXXXXXXXXXXXXXXXXXXXXXXXXXXXXXXXXXXXXXXXXXXXXXXXXXXXXXXXXXXXXXXXXXXXXXXXXXXXXXXXXXXXXXXXXXXXXXXXXXXXXXXXXXXXXXXXXXXXXXXXXXXXXXXXXXXXXXXXXXXXXXXXXXXXXXXXXXXXXXXXXXXXXXX|XX
