-----------------------------------------------------------------------------------------------------------------------------------------------------------------------------------------X|X-BM|o|??MoE-
------------------------------------------------------------------------------------------------------------------------------------------------------------------------------------------Bo--?BXEXE?-E-
-----------------------------------------------------------------------------------------------------------------------------------------------------------------------------------------BT|-?MBXE-|?o-E
-----------------------------------------------------------------------------------------------------------------------------------------------------------------------------------------o--M-M-|XBo-M?-
-----------------------------------------------------------------------------------------------------------------------------------------------------------------------------------------MoXT-?||oo-XBB-
----------------------------------------------------------------------------------------------------------------------------------------------------------------------------------------M-BETMTE-?TBE|B-
-----------------------------------------------------------------------------------------------------------------------------------------------------------------------------------------EoBMM-E?XTo-Eo-
-----------------------------------------------------------------------------------------------------------------------------------------------------------------------------------------XTTBX--BEBBT?ov
-----------------------------------------------------------------------------------------------------------------------------------------------------------------------------------------MMTXEB?XBT-o|?f
-----------------------------------------------------------------------------------------------------------------------------------------------------------------------------------------BEME-BE?MooM?Ef
-----------------------------------------------------------------------------------------------------------------------------------------------------------------------------------------T-ToB??M-XB-E-f
-----------------------------------------------------------------------------------------------------------------------------------------------------------------------------------------XBB-EM-?EE?|XXf
-----------------------------------------------------------------------------------------------------------------------------------------------------------------------------------------o-M?B?XT|B-TMBf
-----------------------------------------------------------------------------------------------------------------------------------------------------------------------------------------o?-M|?--EME-TMf
m----------------------------------------------------------------------------------------------------------------------------------------------------------------------------------------??T-oETB|E??XoX
XXXXXXXXXXXXXXXXXXXXXXXXXXXXXXXXXXXXXXXXXXXXXXXXXXXXXXXXXXXXX-XXXXXXXXXXXXXXXXXXXXXX-XXXXXXXXXXXXXXXXXXXXXXXXXX-XXXXXXXXXXXXXXXXXXXXXXXXXXXXXX-XX-XXXXXXXXXXXXXX-XXXX-XXXXXXXXXXXXXXXXX-XXXXXXXXXXXXXXXX
