-------------------------------------------------------------------------------------------------------------------------------------------------------------------------||BMB-EXTB-EB?oBXMTBB|??B?BTXo-
--------------------------------------------------------------------------------------------------------------------------------------------------------------------------BEMM|XE-oB-ET|EoXMET?XMEX-TX?-
--------------------------------------------------------------------------------------------------------------------------------------------------------------------------TET-E|oooETE-X-XE?-XT?TEE-o?--
-------------------------------------------------------------------------------------------------------------------------------------------------------------------------?|?MXB-o|o?oBo?BMME|XX-B|o?-BT-
-------------------------------------------------------------------------------------------------------------------------------------------------------------------------BM?-BEEM-?TXB-???TTo||BTBE?BME-
-------------------------------------------------------------------------------------------------------------------------------------------------------------------------|?o?oo-XoM---E|M?-E-Bo-?BTX-|--
-------------------------------------------------------------------------------------------------------------------------------------------------------------------------?o-o|ETX-EoTM-|ooE?XTBTEXE-Boo-
-------------------------------------------------------------------------------------------------------------------------------------------------------------------------M|ToXMEEEEM|MEXB??E|E|MB---ME|v
-------------------------------------------------------------------------------------------------------------------------------------------------------------------------oXT|EBXTMTo?MM|Eo-?To?ME-TMXXof
-------------------------------------------------------------------------------------------------------------------------------------------------------------------------BoX|X|M?BXTTXXXMTETEET||MMoBXof
-------------------------------------------------------------------------------------------------------------------------------------------------------------------------TX--E?TEBE?oMXE?E|ooXooT?E|BoMf
-------------------------------------------------------------------------------------------------------------------------------------------------------------------------BT?XXX?MT--oE?B?BT|o?o?MBToo-of
--------------------------------------------------------------------------------------------------------------------------------------------------------------------------M?-TBT?oXE|-?X?oMX-B?EMBMT-oXf
--------------------------------------------------------------------------------------------------------------------------------------------------------------------------oMMXTEXo|BEoB|TEM-BBoEM|?EoBBf
m------------------------------------------------------------------------------------------------------------------------------------------------------------------------TMT-EMX|?XM-|MBoBEBo?XTTEE-|?|X
XXXXXXXXXXXXXXXXXXXXXXXXXXXXXXXXXXXXXXXXXXXXXXXXXXXXXXXXXXXXXXXXXXXXXXXXXXXXXXXXXXXXXXXXXXXXXXXXXXXXXXXXXXXXXX-XXXXXXXXXXXXXXXXXXXXXXXX-XXXXXXXXXXXXXXXXXXXXXXXXXXXXXXXXXXXXXXXXXXXXXXXXXXXXXXXXXXXXXXXX
