----------------------------------------------------------------------------------------------------------------------------------------------------------------------------?-X-EEXo-||XEEooMTM?EBMBMM?-
----------------------------------------------------------------------------------------------------------------------------------------------------------------------------o?EX-X-|BoT?ooE-M-X|M??XT-B-
----------------------------------------------------------------------------------------------------------------------------------------------------------------------------EE-B-o|?BXBMo?BB?|T|BEB?oXE-
----------------------------------------------------------------------------------------------------------------------------------------------------------------------------EX|oEMXE-E|XM-XT|-BB--E--B|-
----------------------------------------------------------------------------------------------------------------------------------------------------------------------------||T-?B-TXTT-MTB-X|?-|To?|oE-
----------------------------------------------------------------------------------------------------------------------------------------------------------------------------XTE|-To|o-XMBMMM-B?XX?X-XXT-
----------------------------------------------------------------------------------------------------------------------------------------------------------------------------?-|-M?MoM||?TXT?BTE-EBoX-M--
----------------------------------------------------------------------------------------------------------------------------------------------------------------------------MB|oo|?XE?TTEXoBMT--BXX-?M|v
----------------------------------------------------------------------------------------------------------------------------------------------------------------------------EX-?BE|To-ETX-BXoXXX-TTT?|of
----------------------------------------------------------------------------------------------------------------------------------------------------------------------------T-Mo-ooo-Bo?TMXMTEM|TB|--oBf
----------------------------------------------------------------------------------------------------------------------------------------------------------------------------|ME-BEXXEEB|TTX-oB-MBME-T-Bf
----------------------------------------------------------------------------------------------------------------------------------------------------------------------------MMXXM-ooMTXE-TB|TXMMME-|-XTf
----------------------------------------------------------------------------------------------------------------------------------------------------------------------------M-Eo|MBTTTM-?M|--MX?BE-BBMBf
----------------------------------------------------------------------------------------------------------------------------------------------------------------------------?|-MT?BE??-|B-XoEBXE?X?--Mof
m---------------------------------------------------------------------------------------------------------------------------------------------------------------------------?E|-BT?TM|EB-?M-Bo-To-X?||?X
XXXXXXXXXXXXXXXXXXXX-XXXXXXXXXXXXXXX-XXXXXXXXXXXXXXXXX-XXXXXXXXXXXXXXXXXXXXXXXXXXXXX-XXXX-XXXXXXXXXXXXXXX-XXXXXXXXXXXXXXXXXXXXXXXXXXXXXXXXXXX-XXXXXXXXXXXXXXXXXXXXXXXXXXXXXXXXX-XXXXXXXX-XXXXXXXXXXXXXXX
