--------------------------------------------------------------------------------------------------------------------------------------------------------------------------------------------------------
---------------------------------------------------------------B-------------------------------------------------------------------X--------------------------------------------------------------------
---------------------------------------------------------------B----------------------------------------------------------------------------------------------------------------------------------------
--------------------------------------------------------------------------------------------------------X-------------------------------------------M---------------------------------------------------
-----------------------------------------------------------------------------------------------o--------------------------------------------------------------------------------------------------------
--------------------------------------------------------------------------------------------------------------------------------------------------------------------------------------------------------
-----------------------------------------------------------------------o--------------------------------------------------------------------------------------------------------------------------------
-----------------------------------------------------------------------------------------------------------------------------------------------B-------------------------------------------------------v
------------------------X------------------------------------------------------------------------------------------------------------------------------------------------------------------------------f
----------X--------------------------------------------------------------------------------------------------------------------------------------------------------------------------------------------f
-------------------------------------------------------------------------------------------------------------------------------------------------------------------------------------------------------f
----B----------------------------------------------------------------------------------------------X----------------------B----------------------------------------------------------------------------f
-----------------------------------------------------------------E-----------------------------------------------------------------------------------------------------o---------B---------------------f
-------------------------------M-----------------------------------------------------------------------------------------------------------------------------------------------------------------------f
m------------------------------------------------------------------------B--------------------------------------------------------------------------------------------------------------------?--------X
XXXXXXXXXXXXXXXXXXXXXXXXXXXXXXXXXXXXXXXXXXXXXXXXXXXXXXXXXXXXXXXXXXXXXXXXXXXXXXXXXXXXXXXXXXXXXXXXXXXXXXXXXXXXXXXXXXXXXXXXXXXXXXXXXXXXXXXXXXXXXXXXXXXXXXXXXXXXXXXXXXXXXXXXXXXXXXXXXXXXXXXXXXXXXXXXXXXXXXXX
