-------------------------------------------------------------------------------------------------------------------------------------X----------B-------------------------------------------------------
-------------------------------------------------------------------------------------------------------------------------------------------------------------------o-------------------B---------B------
-----------------------------------o------------------------M--------------------------------------------------------------------------------------B----------------------------------------------------
--------------------------------------B--B--------------------------------------------------------------------------------------------------------------------------------o-----------------------------
-----------------------------------------------------------------------------------------------o----------------------------------o--------------------------------------B------------------------------
------------------------X-----------------------------------------------------------------------------------------------------B-------------------------------------------------------------------------
--------------------------------------------------------------------------------------------------------------------------------------------------------------------------------------------------------
----------------------------------B-----------------------B---------------------------------------------------------------------------------------------B---------------------------------------B------v
----------------------------B--X---------------------------o-----------------o------o-------M----------------------------------------------------------------------------------B-----------------------f
--------X-----------------------------------------B----------------------------------------------------------------------------------------------------------------------------------------------------f
-------------------------------------------B-----------------M------------------------------------------B---------B----------------------------------------o------------B-------------o----------------f
-----------------------------------------------------------------------------------------------B------------------------o------------------------------------------------------------------------------f
---------------B----o------B-------------------------------------------------------------------------------------------------------------------?-------------------------------------------------------f
--------o----------------------------------------------------------------------------------------------------------------------------------------------------------------------------------------------f
m-----------------B---------------------------------o-------------------o------------------------------------------------------------------------------------o-----------X-----------------------------X
XXXXXXXXXXXXXXXXXX-XXXXXXXXXXXXXXXXXXXXXXXXXXXXXXXXXXXXXXXXXXXXXXXXXXXXXXXXXXXXXXXXXXXXXXXXXXXXXX-XXXXXXXXXXXXXX-XXXXXXXXXXXXXXXXXXXXXXXXXXXXXXXXXXXXXXXXXXXXXXXXXXXXXXXX-XXXXXXXXXXXXXXXXXXXXXXXXXXXXXX
