-----------------------------------------B----------------------------------------------------------------B--------------------------X------------------------------------------------------------------
-----------------------------------?------------------------------------------------------------------------------B--------------------------o---------------------------------------------------B-B----
-----------------------------------------------------------------------------------------------------------------------------?---------------------------------------------------------X----------------
------------------------------------B-----------------B-------------------------------------------------------------------------------------------------o---------------------------------o-------------
-----B--------------------------------------------------------B-------------------------------------------------------------------o---------X-----------------------B----B------------------------------
------o------------------------------o------------------------------------------------------------------------------------------------------------------------------------------------------------------
-----------------------------------------------------------------------------------------------------------------------B--------------------------------------------------------------------------------
-------------------------M--------------------------------B----------------------------------------------------B--------------------------------------------------------------------------------B------v
----------------------------B--X----------------------------------------------------------------------------------------------------------B-----B--------------X---------------------------------------f
--------B-----------------------------------------B----B--------------------------------------------------------------?--B----M------------------------------------------------------------------------f
-------------------------------------------B-----------------M--------------------------------o---------B---------------------------------------------------------------B-------------o-M--------------f
-B--------------------------------------------------------------------------------------------------------------------B----X---------------------------------------------------------------------------f
--------------BB-----------B---------o---------------------------------------------------------------X-------------------------o-----------------------------------------------------------------------f
-------------------------------------------------------------------------------------------------------------------------------------------------------------------------------------------------------f
m--------------X-oB--------------------------------------------------------------------------------------E--------------------------------X------------------------------------------------------------X
XXXXXXXXXXXXXXX-XX-XXXXXXXXXXXXXXXXXXXXXXXXXXXXXXXXXXXXXXXXXXXXXXXXXXXXXXXXXXXXXXXXXXXXXX-XXXXXXXXXXXXXXXXXXXXXX-XXXXXXXXXXXXXXXXXXXXXXXXX-XXXXXXXXXXXXXXXX-XXXXXXXXXXXXXXXXXX-XXXXX-XXXXXXXXXXXXXXXXXXX
