--------------------o--------------------B----------------------------------------------------------------B--------------------------X------------------------------------------------------------------
-----------------------------------?-----------------------------------------------------------o----------------------------------------------------------------------------------------------o--B-B----
-------------o------------------------------------------------------------------------------o----------o-----------------B----------------------B-----------------o-------------------------------------
---------------------------------o--------------------B----------------------B--------------------------------------------------------------------------o-----------------------------------------------
--------o--------------------B--------------------------------B-----------------------------------------------------------------------------------------------------------------------------------------
------o-----------------X------------o------------------------------------------------------------------------------------------------------------------------------------------------------------------
----------------------------------------------------------------------------------------o------------------------------B--------------------------------------------------------------------------------
-------------------------M------------------------------------------------X-----------B------------------------B--------------------------------------------------------------------------------B------v
----------------------------B---------------------------------------------------------------------------------------------E------------------o---------B-------X---------------------------------------f
--------B-----------------------------------------B---------E---------------------------------------------------------?--------------------------------------------------------------------------------f
------------------B------------------------B-----------------M------------------------------------------B--X----------------------------------------------------------o-------------B-o----------------f
----------------------------------------------------------------------------------------------------------------------B-o--X---------------------------------------------------------------------------f
-------------------------------------o-------------------------X---------------------------------------------------------------o-----------------------B--------------B--------------------------------f
--------------------------------------B---------------------------------------------------------------------------------------------------------o-----------------------------------------------------Bf
m-------------------------------------------------------B---------------------------------------------------------E-------------------------X-----------------------B----------------------------------X
XXXXXXXXXXXXXXXXXXXXXXXXXXXXXXXXXXXXXXXXXXXXXXXXXXXXXXXXXXXXXXXXXXXXXXXXXXXXXXXXXXXXXXXXX-XXXXXXXXXXXXXXXXXXXXXX-XXXXXXXXXXXXXXXXXXXXXXXXXXX-XXXXXXXXXXXXXX-XXXXXXXXXXXXXXXXXXXXXXXX-XXXXXX-XXXXXXXXXXXX
