E?|-|-o|-?|-oBME|-|-B-B--BE--|E-MX?-EX-Bo-EMEBTMMB?BMo|XBT-TMT-XEBB-|---E-oMX--X-T-oB--|B?-?X-XBXEEXT----BBMB-oX?TB|T-E-E?-M-MET--|o-oXMT?E-TBoX-|-BMMTEE-X-?---M--XE|oB--oT?-B??||-B||-Eo--ETX-?--T|BoE
-?MoE-X?-X?-T|?EB-B-o-?oBBo-B-o-?BB-MT-|--M-MEXEoBX|MEoMEX-?|?-X?oo-----?--EX--T-?--|---|?TTTX|X||MMX----ToXEEM-TBTEM-EXXMMX-M?---|XMEo?EEX-EoE|-MBM?B|EM-o-XT-TE|--|--o--X||-oToo?--??-TB-|X|M?o--oBX|-
--Xo|-M|--|--o-TB---T-X-E|T-oXT-|XT-|X-EM-T-?|EBEME?X??XT|-X?E-XB-X-X---oTTME--M-|-oT--?TBo|ME|?-XB|E-----MoB||-XXMM---|oE|o-MET--oTXBooTX|-XXBT-T-ToBo|T---EE-M?M--XoMT--T-|-?MEM--EM?-XX-|T||XT--EXE-E
?o|-X-X--XE-?BTM|-?-M-Xo-XX-XTM-B|E-|X-?M-|EMTXo|EE-EX|ToM-|EM-X?BT-----EoBoM--?---?E--BoB-E|oTEM|T-E----BBXT?BTE|MXo-?BTo|B-?oM--Xo-oEB|XX-TEXM-|TXM|B?----TT-MTo--EBEB--TMB--|?Mo-?EM-X|-EM-MT|--XX?EE
-EBT|-|o----TE|X|-E-M-M-EMM--oo-Eo--B|-Xo-TTB-B-B-X-T?EMM?-To?--|M?-|---|MBE?--E-|-ET--EMB-oTEBoEMEX|------??BE?oE-?B-|BB|EB-XET--BEXMMB?ET-MT|T--ooMTXXT-o-o?-TEE-||XBM--?-X-o?M-X-|?E----X?|oBX--?|X?T
BMB-X-M|-|?-X?-Bo-E-o-ooM|M-M|T-TXT-??--|-|E--BoEoB-MTT?TX-M|E-TTTX-B---|MBT?--B-?-T|---XB?|B|TE--ETB-----|oo|EoX-EMX-TTo??o-|oB--XME|MM|MM-XXBT-ETT|E|B--M-XM-|Mo-B??o?--ETT-XToT|-oM---T-?XT-M?--EXo??
XBM|T-?--oB-XoBB|-o-T-o|oT?-|TB-?Bo-TT-oB-?-o-E?XM?Eo|X|MX-B-X-B-Eo-X---BoMBT--o-o-?M--EEMX?BXEB|T|BE----?-XEBXE|oTB?-XXXXo--EBM--?XTT?M-|B-|-|X-EoMM-??M-T-|T-B|E-Bo?|M--E?|-oMXXo-?-?--M-EEooBX--BXBT|
|EXBX-To--M-T-BBM-B-E-EBXM|-?|X-TX|-||-X?-BB??BEM|EEX-Xo-T-EB?-|EXT-M---BE?ME--?-M-B|--|BT||E|o-EETTT----||E|??BT-ETM-EXBTB--EBE--XETTB-|Mo-TMMM-o|T?EMX--o-BE-oME-?XM-X--?oM-EX?oX-ETo-?M-??EME?--??oEv
TEEXE--|-oT-BEX|E-o-?-|X-|B--To-BoT-oT-oB-o?BM-T-oXMXEXTEM-B?B--?XM-B---E?ME|--X-o-|---T?BM|-???Mo?|B----EMB-T?E-o?BX-|?|-?T-?Eo--|T||BTT??-XE|B-oo|?E|BM-?-E|--X|-T|XE---o|E-oEooB-TBT-|X-XX-TBX--BEEX?
oMXBM-|T-?--E?XM?-E-o-BMEMo-?oB-M|M-|--BE-?XEBBXXo|-XMETMB-XXX-XX?|-X---X|-||--X-B-?B--oE-EX?EEBEM-?X----TT?|--??ooB?-MEM|EX-|B----M-E?-o?M-o-EX-XB-B?B-M---Bo-E|T-?oBEo--|B|-M|-|o-||T--T-?M|?----B--?T
oBTET-E|-??-X-|X?---T--BXoo-|-?-?-X-B--oo-EEB-XBBT|E|oET-T-|BT-X--o-T---oo|X?--B---TB---EXoX|ET?XTETX----XBMEoBEMM-M|-X-EMET-E??--T|E|TEXMX--TB?--XMMBT|E-|-TE--MM-oB|XE---M|-E?-TB-TMM--M-TXoBTo--X?--E
-?o?T-oB-BE-E-TX--B-E-|MMXT--TX--o?-Eo-EB-|EM?TT|X?BT--E?E-XXE-BBoo-E---|TMBM----M-XT---|oMB-Mo?ooXTE----oT?oXT?-E|Bo-|-?BTX-Moo--ToTBE??E|-oo|M-EX-E-MTT---X?-XXT-XE??B--TXo-oM-Eo--|E-??-MMXoX?--||ooE
o|MXX-|X-EB-|-E-|-T-M-ETMB?-T-X-TBo--T-|--MEoB?|X??oXoTBMX-||--o-BX-|---MTBX?--?-|-B|--MX?BoBo-???BB|----E-|oEB??o?MM-XTMXMB-TXB--?B-B?BEMB-?MoE-oTBEMo|X-o-?--EBB-X-BT|--TB--?oT||-|MM-oT-oETXEX---XM?E
-|M|B-T?-MT-oooXE-T-X-XXo-|--E--X|o-E?-|o--T?XBTo??T|-TMMo-X||-|-M?-E---TMB|?--T-B-M?-----T-XM---X|B?----MMBMXB-EX?XE-BM?-MB-o?|---M--T|B-T-Bo|T-oB||BE-o-X-B|-XB?-M|XE?---E--X|M|T-M?T-Xo-BX?TBo--EBBTB
moTMo--T-BX---M|--|-M--E|M|-M-B-XoB-BT--?-MMTM??|M-oTX|oT--BBo-X|-?-?---TM?Eo--|-X-To--o?E|--o?o?oo-|----Xoo?TXoB?E|B--oB?oM-E----B?||-XXT--ooTX-ooTXMT-?-|-EB-oo|-E|TT?--ET--|?EEE-EXX----BT?o|B--M?o?M
XXXXXXXXXXXXXXXXXXXXXXXXXXXXXXXXXXXXXXXXXXXXXXXXXXXXXXXXXXXXXXXXXXXXXXXXXXXXXXXXXXXXXXXXXXXXXXXXXXXXXXXXXXXXXXXXXXXXXXXXXXXXXXXXXXXXXXXXXXXXXXXXXXXXXXXXXXXXXXXXXXXXXXXXXXXXXXXXXXXXXXXXXXXXXXXXXXXXXXXX
