|MX-??-E-EE-oB-X--ME---MM||---?--B-ME-?BB-B-||?E?E-|-o-TMT-M--ToBX-B----E-M|----o---o-XB--B-oX?-T-oB-B--?E---|MXo--E---X--oMT--|o----X-oX-TE----?|---|---|--BM-oo--?B-?--TEB|-oo?-BBoE-|?o--o--EMEET-o--
BT--B--?-BE-MBMT--To--XBMXo---E----T|-oMX-T--BBME|-|-X-E|X-T-ET?T|-E----X-EM----T---T--o----XB|-E-?X---MM|---?oXM--|---|--TTT--?E---|E-T--Bo----TE---o-----MEE-Mo---B-T--XB?M-MEB--oTM-o-M--o--||Eo|-X-T
B|M--M-o-|?-oTEE--BE--E?BMX---o--E-XE-MEM-o-XBoEXT-M-?-|?o-X--MTTE-T------M|----o---B-|E--|-?EB-T-Mo-o--TX----MBo--|---T--|-----E---|--E|-BM-----X---B---o-TMo-|?--?--B--|oEB-X|B-E?TM-XET--|--X?BM?-B-|
T|X-oE-B-XE-X--T--T---|X------B--X-EE-|T|-o-M-|EMB-o---|??-?-MTTo-------?-?M----B---|-ME--E-EoB-T-M?-M-TTX---?EXM--E------B?---?M---Bo-M--XX----?B---M---T-?MB-MT---T----MMT--?TB-X?|M-X?E--E--TTEBM-?-T
ME?-ET-?-T?-MXTE--E---TBMX|---M----BE-XoM---BX?M??-B-E-MME-E-oMoX?-?----E-BX----M---E-|o--T--Eo-E--E-M-M|M---o?XE--|---M--|XM--B-----E-?T-MB----MT-------E-|oE-?E-----X--M??M-?-B-EXEX-EBX--E--oT?M?-?-B
XBX-B?----?-E-TM--MX--M?ToE---o--?-??-TTM-?-|M?ME--?-?-EB|-M-XBETT-T----?--M----B---M-XB--M-|E?-M-|M-T-?TB---BBET--M---T--TM|--XT---oM-B--EE----M?---E---M-M|M-|X--BE-X--oE?X--M|-MEEM-?BM--|--?TT|o-o-o
-XE-??-?-?E---BT--EE--B-?BT---X--|-oT-MXT-o-Eo||M?-|-M-TMM-B-T?M?|------?-XM----?---|-oB--X-|BT-E-?E-E-?-M----?T|--|---X--T|T--E?---o--EM-XE----oo---E---o---E-EE--To-o--BE?T--MB-?-E--MB?--E---X||--E-E
-X|-To-B-oB-BTMB--MB--MX-|?---o--|-MM-X-E-|-MBMM|--B-M-|Eo---EBT?E-?----B-TB----B-----Bo--?-TBT---X?-|-TEX---?MEB------|--XoX--BM---Bo----EE----?T-------o-EoE-?X--EX-B--oo|M-ME--M?|?-BMT--?--M|XEB-o-v
-X?-Xo-M--B--BMT--|X--oT?X?---|--E-M|-XTX-o-|BTT?E-|-E-BTB---BX--o-X----o-o?----B---T-XX--X-oTE-X------E-o----EE?--X---o--MMB--?|---XM-B?--E----Xo---M---T-X?M-X?--?|-E--XX-E-EB|--?E--BEM--|--EToM--|-X
ToX-BB---B?-MXoE--XX--?XE-E---?--X-EX-TX--M-EEM?Xo---|-X|o-M--|EMo-o----B-TT--------B-?T--X-BTE-M-oM-X--BE---EBB|------T---ME--BX---TM-|T-Mo----|M---T-----X?B-||--M|-|---EMT-o?--??-B-|-?--?--E-XET-|--
o-T-|X-|-oX-XBE---?|--oEE|E---?--T-|o-MTE-M-oET|BE-|-?-TB--M-MBBXo-T----B-MM----?---B-EX--?-|TX-M-?E-o-BoB---Xo?E--o---M--?BM--E----XT-XB-Eo----ME---E---o-oXM-ME--ME-M---XE--BBM-BMMX-B|?--?--Xo??M-E-T
MT|-E|-X--T-EBME--TX--MX|o?---E--M-TB-?-X-o-XMo-BE-B-E-||X-|-T?M|?-|----?-?X----M---X-oM----TMM-X-oM-X-?M|---??o?--B---o--o|?--?M---T|--M-BT----?|---T---|-BXM-oE--T|-o--M-||-XX|-M?M?-||------XEXME-T--
oME-M|-T-||-X?-o--M?--EMTMB---?--?-Xo-EET-|-oEo|MB-T-o--EE-B-EBBBX-X----B--B----?---o-BM--|-ME|-o-BT-?-oEB---MEB---B---T--?-|---|---oM-|o-ET-----?---X---M-o?o--T--MB----X||X-EXE-X|T--TTo--M--TXTEM-o-o
oE|-TM-|-ET-T?|X--TX--EBT|o---M--X-E|-?oE-E-E-BME|-X-M-EEX-|-?TEoo--------M?----X---?-oT--B-BoB-E-o|-T-BX|---oXXo--?---o--ETB--E?---MX--E-ME----M|-------E-|B?-M---oT-M--|MXB-T-?-?|TX-T-?--|--E|MXB-E-o
mXT-o?-B-EB-oXBo--|---X|TTT---E--?-EE-oTM---EoTBBE-o-E-?EE-B-EM-ME-M----E-XM----T-----BB--B-XMB-M--B-o--?B---M?TM--E---X--M-?--|?---TE-B|-|T----E?---o-----XX--o?--?o-T--oM?T--?E-?|-?-T?B--o--EB|To-o-o
XXXXXXXXXXXXXXXXXXXXXXXXXXXXXXXXXXXXXXXXXXXXXXXXXXXXXXXXXXXXXXXXXXXXXXXXXXXXXXXXXXXXXXXXXXXXXXXXXXXXXXXXXXXXXXXXXXXXXXXXXXXXXXXXXXXXXXXXXXXXXXXXXXXXXXXXXXXXXXXXXXXXXXXXXXXXXXXXXXXXXXXXXXXXXXXXXXXXXXXX
