---T-B--B-B-XM--?-oM|XB----T-BEEMo-M--X--X-B-B--BMXE--B??---o-oo-T-ME-TX?o??ooo--?oM?To--Bo--Eo?E-X-E||---X-B-|-M?XE-|-BM?-TTME-|--T-EE-T----T-X-?XM-|X-XXT-o||B-XB--M-?--?o?E-o--M-M?-o--MX-Mo-?T--M|E-
--oBXBX-X-o-oB--X-|MXXB-----M-BEX?-E--o--B-E----To|X---MT--TT--o-T-?-oX|B?M|TM|--X?--??-XE|?-EToX-M-EXX-?-M-o-M---?EXT-o|X-?X?T-o-MB--E-B--|-o-|-TMBM?M--Xo--BET-EXEM?-T--|BoTo---o-TM-o-E-E-ET-XM--oE--
---BXB?-X-B-oB--o-|EXM-----EoEMXoT----o--|-M|B--E|TB--oXT--?E-Mo-T-|--o?X|MEET?--MTM-B-T|||M-|B?B-E---E-?-T-?-|-?-?oE?-TME--M?T-|-T|-Bo----M-o-E-TXXBB|-TM?-T-?T-|oX---|--M-ToX|--X--B-X--B?-|o-To--|??-
--|E?-M-B-E-?E--T-MTTXM---X-?|?|XT-M--o--?--oB--EMEE---XM--EM-MM-E-T-XTEMTMB?EB---EXMoEXXM?X-EE|?-o--T?---X---?-MB|MBB-E?|-T|XB-X-|?-X?-E--|-T-X-TXMBMX-Mo?-XE?X-?X-|B-?--??T|BT--M-ET-o-|XT-Mo-?o--oX?-
--TBMTX-?-T-MB--M-?EBT?---XTo-T|M--o--T----ooX--|B|---?-T--?--XT-M-o-oBT?MTMEBB--XTTE|MTEM-?---E--o-XoE-----o-X-X?|TT?-XMT-ooo?-|-|X-XX-B--?-B-|-B?MTXX-X---|?TX-MMBE?----BB|M?X--X-BM-B--MX-E--E|--TBM-
--????B-?-?-oT--T-T-BEX---E?MXX?---B--o---------||TM--T?---EB-B--T-B-XMM|T|ETXX---Eo-BM|XEBB-??XB-|-T---?-?-?----BX??B---?-|TXo-B-BE--X-?--M-|---?-M-XE-MXT--E?--o|M?M-E--X?XEoM--B-oX---BoX-??-TM--ToX-
--|XB?B-M-T-?T--M--XB?E---TX-||Too-X--T--E-BB?--X?BM--TBT--|--Xo-o---ETTX?-oETE--T-|TMBM?oTT-B|X?-TBMMo-X-?-|-X-?-MTMX-X|B--?TE-B-oB-E?-?--o-M-E-X-|M-T-To?--XXB-oX|XM-M--ET-TX---o-|--X-BB--EM-B|--EXo-
--?E-?--|-o-BE--T-M??Xo----E-Bo?XX-M-----o-XEE--MM-o--BXE--EE--B-o-?-?X?-B?MXo?--??oo|?BXoB?---TX-E-X??---E-|-E--M?o-|-?o?-|MBB-M-T?--o-o--T-E-|-E-TX?o--BB-T?oX-E---T-o--EXBX?o--E-|T-X-B|E-EB-T---?M-v
--B?E?E-E-B-|E--?-BoBTB---E?--Mo---o--T--|-oTX--XoXE--|BX--T|-EX-M-o-TTMM|T-?oB--|-??E|?B?TM-BE|T-X-?|M-X-|-|-T-?X?XXB-MMM-XM?B-?-?B--?-M----|-o-X|TTEE-X-X-X-oo-|?o|X-M--TTBTM---|--E-|-EMB-BX-TM--|-Tf
--?XMoX-E-X-X-----E?-M-----XoMEMoE-M--|--T-XB---oE-X--TE-E-?---M-o-M-oTTM-?BMX---XoM-||T?E-M-?TMB-?-M?o-o-o--||-MXEEMo-o|o-XBXB-B-|X-oE-?--o-X---oBE?EX-?oo-?|oo-TE-|T-?--|?BT?|----MM-B-B-o-M?-TE--ME?f
--M-??E-X-M-TB--?-oM|?B---oMEXEMXT-M--|----|Mo--BM-E---B?--oT-?|-|-M-EoB|XTBBMT--BoB|XXBTBXo-|-|T-o-MXT-X-|-T-X-E-X|BB-M|--MoTo-E-BE-?o-?--E-M-M-BBM-oM-E|B-|M?---E-M|-M--XoXETT--M-X|-?-TBX-ME--E--XMXf
--EXBX?-E-|--E--?-XTXEE---|-BETX?T----M--X-E?X--|XoB--?Mo--o?-|M---M-TXE?-ToXEE--?-o?EooBEoo-TTT|-?-||o---B-M-o-E-T?-o-o-B-o-BE-M--o-XT-o--E-X-E-ooo-||--??-BXT--X?TET-T--XoMoT---?-T|-B-ooB-XB-XT---Bof
--oT-BX-T-M-----o-Bo??B---?T?oBMBo-|--B--B-|-T--B-|?--oT?--?E-MX-o-?-E?-BMoX?|---oEoo-Bo??ET-XBM--|?X-o-o-?------|XMBM-X??-XE|M-T-?|-??-o--E---M-?||X-M-ooE-T-T--???Mo--M--oTo|E--?-B?-B-MT--|E-E-----of
--TM-?--X-|-|B--o-MMEEM---TM|BT??B----o--M-T-B--E|M|--?XX--B|-oM-T-E-EM?EM-||BM--MXE|-o|B?|?-|-Bo-?-XEoEB-o---B-B?ME-T-oEB-B|-o-M-||-TE-E--o-M-X-MTXMET--??-ooE|-ETBoM----o?T?EM--X-TX-T-EBo-|--M?---oBf
m-XMo|o-|-B-BM--?-EBE?M---TTM-|E|M-X--?--X-T?B---M|T--E?E--|M--|-|-E-?|XoMoMXBM--?||XXoBX--o-|TM--E-TME-X-B-?-E-?-MBX|-|BE-Eo?M-M-EE-|o-B--|-E-|-MTXMEB-M-T-X|-T-BM|M|-E--T?|BBM--T-?--B-M|B-oB-TM--XMXX
XXXXXXXXXXXXXXXXXXXXXXXXXXXXXXXXXXXXXXXXX-XXXXXXXXXXXXXXXXXXXXXXXXXXXXXXXXXXXXXXXXXXXXXXXXXXXXXXXXXXXXXXXXXXXXXXXXXXXXXXXXXXXXXXXXXXXXXXXXXXXXXXXXXXXXXXXXXXXXXXXXXXXXXXXXXXXXXXXXXXXXXXXXXXXXXXXXXXXXXX
