E?----o|-??-oBME--|-T-B--BB----X||?-E|TM--E-E-TM-B-BM||XB-?TM---E-B-|---M-oE---|-X?B---XBM--X-X|XEET--T--BBMB--X?-X?o-M-?-o----ME-|-|TBMT-|-TBTXM|--XMTB--X-?M--M---o?o|-TooT-o|?|X-------E-E--??--||BoE
-?-o--X?-X|-T|?E--B-o-?oBBB-B--B--B-MX|?|-M-ME|E-B-|MooME-X?|-B-?-o----T?--oX--?--M|---?||T-T-|E||MT--E--TMXEE--T-|oM-XXB-M----XM-|-?Eo?E-X-Eo?|EM-MBB|M--M-XB-TE|---B-X-TXX|---oo?-------BoXB-MB--MBX|-
---o--M|--E--o-T----|-X-E|?-o--B?-T-|TEE|-T-?X|B-M-?X??XT-oX?-?-B-X-X--B?TTT---T-M-o---TT|o-M-|T-XB-------EoB|--X-TET-B||-T----|X-o-TXooT-B-XXTToT-T|BoE----Eo-M?M----MM--T|E-oMEMX-------oBTE-BX--EXE-E
?o----X--Xo-?BTM--?-|-Xo-XE-X--XEEE-|MBXT-|-M|?o-E--Eo|To-E|E-E-?-T----MEoBE|--E-TX?---?o---|-TEM|To--X--BMXT?-TE-?|T-|B--------E-X-EE-B|-o-TETMM|--B|BE----T--MTo--MMEM-MTo|--|?MM-------?-MX-oT--EX?EE
-E-T--|o--M-TE|X--E-E-M-EMT-----?B--BTM|?-T-BTT-----T-EMM--To-T-|-?-|--oBMBo?--o-E-B---MM|--T-BoEMEo------X??B-?o-MEM-TB|------BX-B-oEXB?-X-MT|TM--TETXB--o-o|-TEE--M?B|-X?XM---M-T-------oT?--oo--M|X?T
BM----M|-|B-X?-B--E-B-ooM|X-M--EXTT-?-|oB-|--MMo-o--MET?T-oM|---T-X-B--TMMBMT--T--TB---|XT?-B-T---Eo--E---Moo|-oX-ToT-oTM-|----|--X-BXBM|-?-XX-T|E-MoE|T--|-XM-|Mo---|oT-XEXE--MoTB-------MBXo-oE--TXo??
XB-|--?--o|-XoBB--o-E-o|oTM-|--||Mo-T-?MX-?-oX|?-M-EoBX|M-oB------o-X--BMoMoX--o--X----BE?X-B-E||T|---X--??XEB-E|-M|?-|XX-?----?|-?-?XBM--T-|-EXBE-M|-?T--?-|T-B|E---T|--oEM?-?XXX|-------EEE--BX--EXBT|
|E-B--To----T-BB--B-?-EBXME-?--ME||-|o-X--B-?BEE-|-EXBXo--TEB-B-E-T-M--B|E?|B--M-MMX---?B-|-E-o?EETX--|--|TE|?-BT-E-o--XM-M----|M-X-MEo-|---TM|MTo-M?EMB--T-BB-oME--T?---M??T-TT?o--------X??E-Eo--X?oEv
TE-X---|-o?-BEX|--o-X-|X-|B----TBoT-o?B|B-o-BXXT-o-MX-XTE--B?-M-?-M-B--B|?MBB--?-B-o---X?|M---?TMo?T-----EoB-T-E--XBT--?|------B?-|-X|TTT---XE?B-o-BXE|B--o-EE--X|--??EX-Xoo|-MXooE-------E-XE--o--|EEX?
oM-B--|T-??-E?XM--E---BMEM|-?--?MoM-|E|?X-?-E?BX-o--X?ETM-oXX-M-X-|-X--XE|-T---E-|E?---EEoE-?-EoEM-B--B--T-?|--??-Bo?-ME--?----||---TTT-o-|-o-XXMX-?M?BM--?-B|-E|T---|ET-M|X|-||-|T-------T?MT-|---o--?T
oB-E--E|-?|-X-|X----E--BXo?-|---M|X-BB-|B-E-B??B-T-E|?ET--X|B-T---o-T--TXo|?M--o-|MB---?E-o-|-TBXTE|--M--XXMEo-EM---M---B-X----Xo-T-B?EEX-?--T??---?BBTo--X-TB--MM--BEX|-E-|o-TE-T----------X---o--M?--E
-?-?--oB-B?-E-TX--B-o-|MMXT-----?-?-E?TTo-|-M|oT-X-BT?-E?-BXX-|-B-o-E--MXTMoE--?-BMB---?|XM---oMooXT--T--oo?oX-?--MEX-M-B-X----M|-T--oT??-E-oo|MME-M?-M---?-Xo-XXT--MB?o-oT-E-XB-E?--------MMB-??--B|ooE
o|-X--|X-E|-|-E---T-o-ETMBo-T--B||o--MoTo-M-o-X|-?-oX?TBM-X||-----X-|--ETTBM---M-MME---oXoB-B--???BE--B--E?|oE-??--E--MT?-E----|T-?-oT?BE-T-?M?E?o-TMMo---|-??-EBB--?oT|-MTET-|?T|o-------XEEE-Xo--BXM?E
-|-|--T?-Mo-oooX--T-T-XXo-M----X-Xo-E-BE|---?T-T-?-T||TMM-?X|-B---?-E--ToMBEB--X-EEM---X-TT-X--E-X|M--o--MEBMX--E-Bo?-EM--B----M----Xo?|B-X-BooTXo-EoBE?--E-BT-XB?--TXEM---oB-BXM|B-------M|Xo-Xo---BBTB
mo-M---T-BM---M|--|-B--E|MT-M--M?oB-B|o||-M-T?-?-M-oTB|oT-MBB-?-|-?-?--XXM?-B----E|B---E?||---?o?ooE--T--X|o?T-oB-----?oT-o----o?-B-?TXXX---ooXXoo-ToMTB----EM-oo|--o?TX-oEE?-E?EE--------XTTM-MB--o?o?M
XXXXXXXXXXXXXXXXXXXXXXXXXXXXXXXXXXXXXXXXXXXXXXXXXXXXXXXXXXXXXXXXXXXXXXXXXXXXXXXXXXXXXXXXXXXXXXXXXXXXXXXXXXXXXXXXXXXXXXXXXXXXXXXXXXXXXXXXXXXXXXXXXXXXXXXXXXXXXXXXXXXXXXXXXXXXXXXXXXXXXXXXXXXXXXXXXXXXXXXX
