----EBo-M-B--M--M-XM|-oB?--T-B-EMMXM--X-BX?B-B--XMXE--B??---o-o|-E-M-E-E?oo--oo|-o?T?ToE-E---Eo?E-X-E||-|-T--T|oo|X|-|TBX-|TTMEoX-ToBM|MT----|oX-?XM-|---XT-o||B--BB-M-?M-?o---o--M--ETo---X-M|-?E--M-E-
--o-?BB-M-?-MB--M-BMX-B-o-?-M--EX-BE--o-XBoE----Bo|X---MT--TT--T-M-?-oTEB??T-M|M-|?T-??X-E??-EToX-M-EXX-E-|--XM?TT?oBTToB-E?X?TT|--B|X?EB--|BTBM-TMBM?---EE--BEo--XoM?-T|-|B--o---o--MEo-E-E-EB-X?--o---
----TBX-o-|-?B--o-|EX-X?B-MEoE-Xo-B---o-o|EM|B--M|TB--oXT--?E-MX-M-|--TEX|XX-T?M-E-?B|---||M-|B?B-E-X-E-E-M--o|Xo|?MX?oT--E-M?TTo-XEooMT---M|?MT-TXXBB---MX-T-??--oT---|B-M---X|--X--oXX---?|---TE--|-?-
--|-X-B-M-|-?E--E-oTT-E|B-M-?|-|XTTM--o--??-oB--BMEE---XM--EM-MB-E-T-XTEMTBo-EBM-?XTMoE|-BMX-EE|?-o--T?---E---?oXX|MBBMEE-XT|XBME-MX-o?TE--|oT|B-TXMBM---o--XE??--X-|B-?E-??--BT--M--|Xo-|-T-M?-?X--o??-
--T-XTX-X---BB--o-|EB-MoM-|To--|MM-o--T-|T?ooX--MB|---?-T--?--X|-E-o-o?|?MXE-B-B--?|E|M?-oE?---E--o-XoE-|-E--oX?oX|BE?-XM-Xooo?TE--ETo?EB--?ETTX-B?MTX----B-|?T---MTE?--o-BB--?X--X---BB---X-E|-Eo--T-M-
--?-??M-M-?-oT--M-B-B-M|E-T?MX-?-?-B--o-?-M-----E|TM--T?---EB-BT-E-B-X?-|TTM-XXE-?TT-BMM-o?B-??XB-|-T---X-M--o-oT|X|oBX-o-B|TXoBX-BM|M?M?--M|BTM-?-M-X---XB--E?X--|E?M-E--X?--oM--B--?T--B-X-?X-TX--T-X-
--|-M?B-B-o-XT--o-?XB-TXT-oX-|-ToEXX--T-BEBBB?--X?BM--TBT--|--XT-?---E-?X?|--TE?-MEMTMBT-oTT-B|X?-TBMMo-|-T--MXXXBMB|X|XM---?TE?T-ET-ETE?--o?|B|-X-|M----oB--XXM--XMXM-MM-ET--X---o---|X-B---E?-B|--E-o-
--?-??|-T-X-?E--?--??--?|-TE-B-?X?|M----Eo?XEE--BM-o--BXE--EE--?-?-?-?||-B|--o?X-EEoo|?X-o-?---TX-E-X??-T-?--oE?||?ME|o??-M|MBBT---EMBoBo--TTETT-E-TX?---B|-T?oX---o-T-o--EX--?o--E--T-X-B-E-EB-TM--?--v
--B-B?--M-o--E--o-EoB-XMB-M?---o-T-o--T-B|EoTX--XoXE--|BX--T|-E?-M-o-T-?M|M|-oB--Eo??E|E-|MM-BE|T-X-?|M-|-?--TTM|??T?B|M--oXM?BTB-o-?oooM---BE|M-X|TTE----M-X-oo--?T|X-MM-TT--M---|--Mo|-E-B-BB-TM--|-Tf
--?-ooB-?---|---|--?--o-?-EXoM-MooXM--|-o|BXB----E-X--TE-E-?---E-E-M-oMTM-E--X---|T--||?-?-M-?TMB-?-M?o-o-|--||-X-EE|oXoo-?XBXBXB-o|?ETE?--o??||-oBE?E---o?-?|o?--ET|T-??-|?--?|-----X|B-B-o-M--TB--M-?f
--M-M?M-M-|--B--X-oM|-TTX-EMEX-MXMBM--|-|-B|Mo--BM-E---B?--oT-?|-B-M-E?B|XX|-MTB-oM?|XXo-|Eo-|-|T-o-MXT-|-E--|X-oMX|MBoME-|MoToMB-EE||TM?--EMTXE-BBM-o---|E-|M?E--ETM|-M?-Xo--TT--M--?-?-T-X-M?--B--X-Xf
--E-BXE-T-T-ME--o--TX-oo--E-BE-X?BE---M--XBE?X--?XoB--?Mo--o?-|E-E-M-T?-?-?X-EEB-B???Eoo-XBo-TTT|-?-||o-T-E--ToEB|TXooMoB-Mo-BEBT-TX?B|-o--EToEB-ooo-|---?o-BXT|--?|ET-TB-Xo--T---?--?MB-o-B-XT-XE----of
--o-TBM-?-?-M-----Eo?-oM?-ET?o-MBT-|--B-MBo|-T--M-|?--oT?--?E-MB-|-?-E|MBM|M-|-B-M?Mo-BT-oMT-XBM--|?X-o-X-E--o-BEMXMoMXXT-TXE|MT--XTX-EXo--E-?T?-?||X----oT-T-TM--?XMo-MT--o--|E--?--E-B-M---||-EX----of
--T-B?X-M-E-XB--E-XME-ME|-TM|B-??XT---o-|M?T-B--?|M|--?XX--B|-oM-T-E-EoMEM?--BM--?To|-o|-Xo?-|-Bo-?-XEo---X--BBoBXM--T|o|-|B|-oMB-EBX-o-E--o-?TX-MTXME---?--ooE|--TXoM--E-o?--EM--X---TT-E-o-|T-MM----Bf
m-X-E|?-M-B-?M--T-XBE-|-?-|TM--E|XXX--?-ooXT?B---M|T--E?E--|M--E-M-E-??ToM-B-BM|-E|MXXoM-TBo-|TM--E-TME-T-|--TEE--MT||E|X-?Eo?M|o-MBEXM-B--|B-E?-MTXME----T-X|TM--M?M|-E--T?--BM--T--ETB-M-B-o|-T?--X-XX
XXXXXXXXXXXXXXXXXXXXXXXXXXXXXXXXXXXXXXXXXXXXXXXXXXXXXXXXXXXXXXX-XXXXXXXXXXXXXXXXXXXXXXXXXXXXXXXXXXXXXXXXXXXXXXXXXXXXXXXXXXXXXXXXXXXXXXXXXXXXXXXXXXXXXXXXXXXXXXXXXXXXXXXXXXXXXXXXXXXXXXXXXXXXXXXXXXXXXXXX
