--------------------------------------------------------------------------------------------------------------------------------------------------------------------------------------------------------
--------------------------------------------------------------------------------------------------------------------------------------------------------------------------------------------------------
--------------------------------------------------------------------------------------------------------------------------------------------------------------------------------------------------------
--------------------------------------------------------------------------------------------------------------------------------------------------------------------------------------------------------
--------------------------------------------------------------------------------------------------------------------------------------------------------------------------------------------------------
--------------------------------------------------------------------------------------------------------------------------------------------------------------------------------------------------------
--------------------------------------------------------------------------------------------------------------------------------------------------------------------------------------------------------
-------------------------------------------------------------------------------------------------------------------------------------------------------------------------------------------------------v
-------------------------------------------------------------------------------------------------------------------------------------------------------------------------------------------------------f
-------------------------------------------------------------------------------------------------------------------------------------------------------------------------------------------------------f
-------------------------------------------------------------------------------------------------------------------------------------------------------------------------------------------------------f
-------------------------------------------------------------------------------------------------------------------------------------------------------------------------------------------------------f
-------------------------------------------------------------------------------------------------------------------------------------------------------------------------------------------------------f
-------------------------------------------------------------------------------------------------------------------------------------------------------------------------------------------------------f
m--X---X-X---------X-----------X--X--X---------------------X-------X-------X-----------X-----------------------------X------------------------X--------------------------------------------------------X
XX--XX--X--XXXXX-XX-X-XXXXXX-X--XX-XX-X-XXXXXXXXXXXXX-XXXXX-XXXXXXX-XXXXXXX-XXXX-XXX-XX-XXXXXXXXXXXXXXXXXXXXXXXXXXXXX-X-XXXXX-XXXXXXXX-XXXXXXX-XXXXXXXXXXXXX-XXXXX-XXXXXXXXXXXXXX-XXXXXXXXXXXXXXX-XXXXXX
