?----------------------------------------------------------------------------------------------------------------------------------------------------------------------------------------------------|--
o----------------------------------------------------------------------------------------------------------------------------------------------------------------------------------------------------|--
-----------------------------------------------------------------------------------------------------------------------------------------------------------------------------------------------------T-M
oo---------------------------------------------------------------------------------------------------------------------------------------------------------------------------------------------------|-?
|----------------------------------------------------------------------------------------------------------------------------------------------------------------------------------------------------|-B
T----------------------------------------------------------------------------------------------------------------------------------------------------------------------------------------------------T-B
B----------------------------------------------------------------------------------------------------------------------------------------------------------------------------------------------------T-|
T------------------------------------------------------------------------------------------------------------------------------------------------------------------------------------------------------E
M----------------------------------------------------------------------------------------------------------------------------------------------------------------------------------------------------T-E
T----------------------------------------------------------------------------------------------------------------------------------------------------------------------------------------------------T-?
X----------------------------------------------------------------------------------------------------------------------------------------------------------------------------------------------------T-B
-X-?M------------------------------------------------------------------------------------------------------------------------------------------------------------------------------------------------T-B
?oB----------------------------------------------------------------------------------------------------------------------------------------------------------------------------------------------------E
|?---------------------------------------------------------------------------------------------------------------------------------------------------------------------------------------------------T-T
mBX----------------------------------------------------------------------------------------------------------------------------------------------------------------------------------------------------E
XXXXXXXXXXXXXXXXXXXXXXXXXXXXXXXXXXXXXXXXXXXXXXXXXXXXXXXXXXXXXXXXXXXXXXXXXXXXXXXXXXXXXXXXXXXXXXXXXXXXXXXXXXXXXXXXXXXXXXXXXXXXXXXXXXXXXXXXXXXXXXXXXXXXXXXXXXXXXXXXXXXXXXXXXXXXXXXXXXXXXXXXXXXXXXXXXXXXXX-X
