----oB?-M|B--M--?-XM|-oB--?T-B-XoMXMEo--BX?--X--X-oE--EE?--oE-?|-E-M-E-E??o--oo|-o?T?ToE-E-MTEM?E-X|E?|-|oXB-?|oo|BM-|TB--|TT-Eo|-ToTM||E----?-X-|X?-|--?XMToEXB--B--E-?M-?M?--o---|MM-----X-M|-?E-TM-E-
-Mo-XBX-MX?-MB--X-BMX-B--TX----XE-BM-M|-XBoM-M--B?|X---|T--MX-|T-M-?-oTEB-?T-M|T-|?T-??X-E?XXEXoX-MTE|X-EBMT-T??TTM-BT?o--E?XMTTo--BXX?E??-|-E-M-|M|-?--|EEo-M-o--XEMT-T|-|Eo-o---ToT----E-E-EB-X?-|o---
-T--MBE-oM|-?B--o-|EX-X?-BXE-E-B?-B--XT-o|E-|M--MMTB--TXT---X-?X-M-|--TEXEXX-T??-E-?B|---||B|||?B-ETXXEME?TT-XBXo|?|X?|T--E-M?TTT-XEXoM?X|-M-?-T-oXM-B--XM|XT-T?--oX-o-|B-MXT-X|--|o-M-----?-|--TE-E|-?-
-||-B-M-MM|-?E--T-oTT-E|-E|--|-oMTTMMTo--??Eo?--Bo?E--M?M--?o-TB-E-T-XTEMoBo-EBB-?XTMoE|-BMEEEM|?-oB-o?|--XM-oEoXXoMBB?E--XT|XBM--MX|o?TXT-|-?-B-EX--M--oo-XXo|?--X-|o-?E-??T-BT--X?ET---|-T-M?-?X-?o??-
-oT--TE-XT--BB--M-|EB-Mo-BXT---M-M-oB||-|T?|oo--ME|---E|T--EE--|-E-o-o?|?oXE-BB?--?|E|M?-oET---E--o-XMEM|M-E--o?oXX-E?MX--Xooo?TE--EMo?MT--?---X-X?B-X--E-BB|?B---MBEE--o-B-|-?X--oXB?-----X-E|-Eo-MT-M-
-X?--?M-MB?-oT--T-B-B-M|--T?-X-BM?-B|Bo-?-MB-E--EMoM--B?---||-oT-E-B-X?-|?TM-XX?-?-T-BMM-o?E|?XXB-|BTE-BX|?B-?|oT|o|oBT---B|TXoB|-BMTM?|?M-M-B-M-M-E-X--oX||-M-X--|M?T-E--XEX-oM--E?oB---B-X-?X-TX--T-X-
-T|-E?M-Boo-XT--M-?XB-TX-|-X-|-TXEXX-??-BEBXB|--XEXM--||T--EM-TT-?---E-?Xo|--TET-MEMTMBT-oT|?BBX?-T|M-oT|-?|-XEXXBTo|XEX----?TE?|-EToETMoE-o-X-|-E-|----ooXX-?TM--X|XE-MM-ET--X---?o|o---B---E?-B|-|E-o-
-|?-??|-TEX-?E--T--??--?--TE-B-o|?|MMXB-Eo?TEM--BXMo---EE--T?-o?-?-?-?||-o|--o?T-EEoo|?X-o--X-XTX-E|XE?MTME?-|B?||?TE|o?--M|MBBT---E?BoX|B-T-T-T-M-|-?--EB?-TEoX-----B-o--EoB-?o--oB|----B-E-EB-TM-M?--v
-EB-??--Moo--E--?-EoB-XM-T|?---o-T-oMoB-B|EET---XToE--MMX---B-X?-M-o-T-?MXM|-oB|-Eo??E|E-|M-EBT|T-XE?BMM|?|E-M?M|?|??BoM--oXM?BT?-o-Moo-|?---B-M-?|E-E--T-XEXX?o--?o|--MM-TMB-M---oE-B---E-B-BB-TM-?|-Tf
-??-To--?---|------?--o--XEX-M-XEoXM||T-o|BMBM---?oX--T-----E--E-E-M-oMTMTE--X---|T--||?-?-T|??MB-?|MBo-oMoB-o--X-XB|oBo--?XBXBXB-o|?ETT|--o-M-|-BBM-E--To|??T??--E-|B-??-|?B-?|--??M?---B-o-M--TB-MM-?f
-BM--?T-MT|--B--?-oM|-TT-T?M-X-|-MBMoEB-|-BMMX--BETE---E?---o-X|-B-M-E?B|MX|-MT?-oM?|XXo-|E-||?|T-o|M-T||-|?-o|-oMMBMBoM--|MoToMo-EEM|TM-?-E-?-E-?B|-o--M|M||--E--E-M--M?-X-X-TT--o-XX---T-X-M?--B-TX-Xf
-EE-?X|-TBT-ME--?--TX-oo-|?--E-XXBE-MBT--XBT?E--??XB--XMo--T--oE-E-M-T?-?-?X-EEM-B???Eoo-XBoTT-T|-?M|oo-T-B?-EBEB|E-ooTo--Mo-BEBB-TXBB|?MB-E-?-B-Mo--|--T??BBX||--?TEE-TB-X-M-T-----TB---o-B-XT-XE-E--of
-To-|B--???-M---o-Eo?-oM--|T-o-MoT-|BTM-MBoB-B--MMo?--MT?--T|-|B-|-?-E|MBX|M-|-E-M?Mo-BT-oM?BXBM--|oXEoTXB?o-o?BEM-EoMoX--TXE|MT|-XT|-EX-X-E-o-?-M|o----ToX?TTMM--??M|-MT--MT-|E--?|B?---M---||-EX----of
-ET-???-MEE-XB--o-XME-ME--BM-B-T|XT-??B-|MX|-B--?o||--E?X--oo-XM-T-E-EoMEM?--BME-?To|-o|-Xo-M|TBo-?BXBo?EooM-BXoBXo--T?o--|B|-oM|-EB?-o|XM-o-|-X-?T--E--|?|-oB-|--TBoo--E-o?T-EM--|oTB---E-o-|T-MM-E--Bf
mXX-X|X-MBB-?M--?-XBE-|--EoT---o-XXXo||-oo-M?----?|T---|E--E---E-M-E-??To?-B-BMX-E|MXXoM-TB-M||M--ETTXE?T?BT--EE--?-||o|--?Eo?M|?-MBoXM-?E-|-o-?-|TX-E--M--BXX?M--M|MB-E--TX|-BM--BB?----M-B-o|-T?-BX-XX
X-XXXXXXXXXXXXXXXXXXXXXXXXXXXXXXXXXXXXXXXXXXXXXXXXXXXXXXXXXXXXX-XXXXXXXXXXXXXXXXXXXXXXXXXXXXXXXXXXXXXXXXXXXXXXXXXXXXXXXXXXXXXXXXXXXXXXXXXXXXXXXXXXXXXXXXXXXXXXXXXXXXXXXXXXXXXXXXXXXXXXXXXXXXXXXXXXXXXXXX
