--------------------------------------------------------------------------------------TB|oT-|?XB--------------T-----------|X----------------------------------------------------------------------------
--------------------------------------------------------------------------------------?oETBXB|?Eo------------?|-----------T?----------------------------------------------------------------------------
---------------------------------------------------------------------------------------o?E||M-o-MM----------T-B-----------?E----------------------------------------------------------------------------
--------------------------------------------------------------------------------------BM--o||X|EXB-----------X------------?X----------------------------------------------------------------------------
--------------------------------------------------------------------------------------?-Mo?MBXMMTM-----------ME-----------|-----------------------------------------------------------------------------
--------------------------------------------------------------------------------------BEM-|--M-X|------------XT------------E----------------------------------------------------------------------------
--------------------------------------------------------------------------------------T|-MoMXE|XoB-----------XE-----------?-----------------------------------------------------------------------------
--------------------------------------------------------------------------------------oT??B-EB-EEX-----------TE-----------Mo---------------------------------------------------------------------------v
--------------------------------------------------------------------------------------E--|BMMXETo------------M?----------------------------------------------------------------------------------------f
--------------------------------------------------------------------------------------|XE--?--TM|o-----------?B-----------XB---------------------------------------------------------------------------f
---------------------------------------------------------------------------------------|-X|MXEToB?-----------ET-----------oX---------------------------------------------------------------------------f
---------------------------------------------------------------------------------------BXoEET--BTE-----------o-E-----------T---------------------------------------------------------------------------f
--------------------------------------------------------------------------------------B|-T-BE-o-X|-----------Bo------------E---------------------------------------------------------------------------f
--------------------------------------------------------------------------------------oMM|TBE--||X-----------M|-----------T----------------------------------------------------------------------------f
m-----------X-----------------------------------------------------------X-------------T-B-o-o-BXoT----X------EE-----------o?X----------X---------X------------X-----------X----------------------------X
XXXXXXXXXXX--XXXXXXXXXXXXXXXXXXXXXXXXXXXXXX-XXXXX-X-XXXXXXXXXXX-XXXXXXXX--XXXXXXXXXXXXXXXXXXXXXXXXXXXX-XXX-XXXXXXXXXXXX-XXXX-XXX-XXX-XX-XXXX-XXXX-XXXXXXXXXXXX-XX-XXXXXXXX-XXXXXXXXXXXXXX-XXXXXXXXXXXX-X
