|?E---oo-|TM--TMB--X|B?MXEo-B-B|X-E-B?EBX|MEEM-?E-o?M|M----MXX|E-T?-?oT-E?E-|E--|-M|E-M--XTXTE-ET?-BTTXBX-E-M?-M|B?-MM|M|EXXX--B-E-B---E-|o-?-MBTBT?M---X-?-M|M-B-T-MB--?-|BB--oEoB?|o--B-|Xo|X-?|X?-MBB
MEM?-|?B--EB--TTTEX-MT--EXM-|---TBBMB|-B---||o--X-|-?M|----XBoM--Eo--E-M-?|XMEo?XX-?X|--?X|T|T--|X-|M-|BX-E-??BB-?T-BBEo|M?BME-T-M----X?--TMoTMB|-BX|XE-X-?-XTE-X--B|B--|-o-XB---?M-T|--o-XM-XEE|?TT-|-E
M-TEEo?--?-E--M-|TX-ETTo|EXBB-XX?|-MBXX|B-EoT|-XB||E-??----?E?o?-Bo-EEBMoXM-oBT-TE-?-M|-MB-?X?-M-o-MBoo---o-B-MXoETT-XEMEo-XoB-E-B----M--oX|XXoM-E?-MM|??-E-T-M-X-|-EX--|M-|X---B|?-Xo--?-oMo-B-|-TT-T|X
??-o-?-X--TM--BB-MoBo?|Mo?TM--oTEM??B-X-T-T-X|-EE-|o?----M-Moo|X-TE-MM?-|-X?M-?----??BE-T-?E-B-|TB-oMXTEEXB-ETEoMB---T-MMT|T-|-B-X-|--o|-TTT-?XTE-XMB|EBX---XT?---?-EB---TTBBXB-o|-XTM--?-T?B?X-?MT?-B?B
TEMB--|E-T-T--X?MBToX?Eo||M?o-|?EXT|E-EEE-oTXB--o-M-o-|--B-M-o-M-ET---TTM?|TXTTM|T-oXEXXMo-EB--|?|-TETXXM-o-BXX-T-o-To?Mo--ooX-B---B--o?-BME-|EToMBXoM-oM-|-|o--M---T|--MEo-XMToE-||-o--o--TEoX-TT|?-??o
TXET-X?B--TX--ToX|-EXoT|-oBEo-?BMM-EB-X?M-MMTT|E-M-EEE---M-TBX?T-E?--XEXMoBoEM?BME-XMB??M-?o?B-X-B-o--BBB---oo|T?-E-M--||-?oTT-T-?-o--o?-MMo?M|B-B?EXB-B--B-----?-X--X--X-??-|B|BB-BoB--|--|-Mo-?T|X--|E
MEB|--M|-|M-?--M-||-EToBoMEX--TM-Xo-MXXTB-?EBE-TE-TB|BM--|-M|-o?-BM-?MB?BTX|oooT||-B?-T-M-X|-X-|E--B-EMXE-?-MM|?EXB-o-oMooMXEE-E-|----B--?oMM?ooM-MEXo|-M-M-BM--T-B-B-T-E--EM|-MT-TTBT--T-EE|EETTEE|-|TT
ToBT-|B--EEM--o-M|T|TM--TTMTM-T-XMEB?BoXT-Mo?--|--?-TT---X-?X-TB-Bo--MXB-||E-EoT?M-B?BTo?TTMBo-XBo-?-o|-o-M--ETMTo?-XBoT-To?XB-E-E-?--o---?MoTE|MTo-?Mo-o-T-?-B-M-|-?T--ooM-BX-X-EXTXM--o--o|---o|-?--?v
?MoT-M-X-oB---oXoE|E-TE-MBEo--Xo|o?-To-oM-MBo-TMB-MX|XT--o-XTo-X-oE--|TE|ooMXETTXM-XMXE|oBTXB?-XE---Xo?TT-E-M-X?T-o-TB-T?oM|XE-o---?--XX-X-EooTXBMoMEMBM--T-E||---X-----M-XMXM-ooEE|T---M--TToT-T-BE-MT?
BTX--EEX--T---?-XB-MTooTBMXE-|o?MM|E-BMo?-|ooE-|B--o-----?-TX|?---M-?XT----ToEE||E||BXB??o-?o--|-?-|ETTXo-T-|?---BB-X|-E??--|E-E-B-|---T-T-|T??BEo??BTBEM-X-|Bo-T-T-X---B-X|BM-X-M|oME--E-Xo|oE-o----TE-
?ET-XMBE-M|X--TEMoM-|MMT?Xoo--E?o-o?-T|-|-?ET|-X|-BBoB---M--|TEo-X?-??|BBXT|TEM-?X-oX-E?oM|E|?-?EB-EB|E---M--oXB-MB--T?EBTo--o---T-?--Xo-??-MoM--BoM-ETB?-M-B-E-T---Mo--?|MM|-BXX-?E||--E-?TMX--T?-?-|T-
-TE--ET---|X--|EMoBT?o-?-EoET-??-EM-XoE?X-M|BB-||-X-M-E--|-|ME?X-|?-M-o?E-M-X-o|?--?-M-MTMB-|B--XB-M|-T|B---E-|TM-M--?E-BX-|MB-B-T---EEoTo?X-?MBoEE--o|?E-o-To?-|-B-BM--E?ooMM--oM-BMT--T-o-TTX-|oo?--M?
-BoT-|E|-X?|--B?|-M-|MBMEX-B----B-Xo-MoXB--|-B-EX-BB|T|--X--?oEB-EXMoB-XToBXMTB-B|--XBE?EBE--B-?M--TX-X-o-T---B?||B-EB?-B|-?MB-X-|-E--||-M-XTE|E-BT|B?TT--B-oE--E-oB-E---EMoXT-?T?M-BE--E-Mo|Eo-MBoo-T?o
T?T?-|EX-oM|--M-BXE-|B-oX|B|T-|oEB-MoE?TX-BMME-E--M?T-?-EX-MM-TB-|B--MTT-E-?-o?TXX-?-TB???-?E|-TB|-X-oX-X-M--oXXE-T-?|o-oo|B|?-|------Xo-ooo-TM--|--oETTX-B-o|B-B-M-??--BT?B|--XMMB-XX--B-?E-|--E?-E---?
mToXXXXo-M-E--XTX|X|??oMBB-T---?Bo-M||XoB-TM||-T--EoMXE--T--B|-E-T?-MT|XT?T-MBBXEM--EXE|Eoo-EE-E---oX-E?E-?-EX-|E|E-?|X?E|E-|?---X----Xo-BMo|T-XoX--?TTMo-|-|TT-|---E-TooXEEX|METTX|?X----?BE-B-o?Mo-XM?
XXXX-XXXXXXXXXXXXXXXXXXXXXXXXXXX-X-XX--XXXXXXXXXXXXX-XXXX-XXXXXXXXXXXXXXXXX-XXXXXXX-XXXXXXXXXXXXXXXXXXXXXXXX--XXX-XXXX-XXXXXX-XXXXXXXXXX-XXXXXXXXXXXXXXXXXXXXXXX-XXXX-XX--XXXXXXXX-XX-XXXXXXXXXXXXXXXXXX
