-----------------------------------------B----------------------------------------------------------------B--------------------------X----------B------o------------------------------------------------
-----------------------------------?------------------------------------------------------------------------------B--------------------------o---------------------------------------------------B------
------------------------------------------------------------------------------------------------------------------------------------------------------o--------------------------------X--?-------------
------------------------------------------------------B----------------------------------------------------------------------------------------------------o--------------------------------------------
-----B--o-----------------------------------------------------B-------------------------------------------------------------------o--------------------------------------B------------------------------
------o------------------------------o------------------------------------------------------------------------------------------------------------------------------------------------------------------
-----------------------------------------------------------------------------------------------------------------------B--------------------------------------------------------------------------------
----------------------------------------------------------B---------------------------------------------------------------------------------------------B----------------------------------------------v
---------------o------------B--X----------------------------------------------------------------------------------------------------------B------------B-------X---------------------------------------f
--------B-----------------------------------------B-------------------------------------------------------------------?--B----M---------------------------------------------------------------B--------f
------------------B------------------------B-----------------M--------------------------------o---------B--------------------------------------------------o--------------------------o-M--------------f
----------------------------------------------------------------------------------------------------------------------B--------------------------------------------------------------------------------f
--------------B------------B---------o-----------------------------------------------------------------------------------------------------------------B---------------------B-------------------------f
-------------------------------------------------------------------------------------------------------------------------------------------------------------------------------------------------------f
m-----------------------------------------------------------------------------------------------------------------------------------------X-X----------------------------------------------------------X
XXXXXXXXXXXXXXXXXXX-X-XXXXXXXXXXXXXXXXXXXXXXXXXXXXXXXXXXXXXXXXXXXXXXXXXXXXXXXXXXXXXXXXXXXXXXXXXXXXXXXXXXXXXXXXXX-XXXXXXXXXXXXXXXXXXXXXXXXX-X-XXXXXXXXXXXXXXXXXXXXXXXXXXXXXXXXX-XXXXX-XXXXXXXXXXXXXXXXXXX
