----------------------------------------------------------------------------|---------------------------------------------E?MXT?------------------------------------------------------------------------
---------------------------------------------------------------------------------------------------------------------------TEMEo------------------------------------------------------------------------
-----------------------------------------------------------------------------?---------------------------------------------B-X|E------------------------------------------------------------------------
----------------------------------------------------------------------------?|----------------------------------------------TEoM------------------------------------------------------------------------
----------------------------------------------------------------------------To--------------------------------------------|-T|M?------------------------------------------------------------------------
----------------------------------------------------------------------------TB--------------------------------------------EX-E-T------------------------------------------------------------------------
----------------------------------------------------------------------------BT--------------------------------------------|MM|-o------------------------------------------------------------------------
----------------------------------------------------------------------------XM--------------------------------------------|BEoBo-----------------------------------------------------------------------v
----------------------------------------------------------------------------|E--------------------------------------------M?-EX------------------------------------------------------------------------f
----------------------------------------------------------------------------MX--------------------------------------------|?|-TM-----------------------------------------------------------------------f
----------------------------------------------------------------------------?---------------------------------------------XBXMoT-----------------------------------------------------------------------f
-----------------------------------------------------------------------------o--------------------------------------------EMBTTE-----------------------------------------------------------------------f
----------------------------------------------------------------------------Xo--------------------------------------------o-oX-B-----------------------------------------------------------------------f
----------------------------------------------------------------------------?B--------------------------------------------?MEoMM-----------------------------------------------------------------------f
m--X---X-----------X-----------X--X--X---------------------X-------X-------XXM-X-------------X-----------------------X----T|B|?--------X--------------X------------------------------------------------X
XX--XXX-XX-XXXXX-XX-XXXXXXXX-X--XX-XX-X-XXXXXXXXXXXXX--XXXX-XXXXXXX-XXXXXXX--XX-XXXXXXXXX-XXX-XXXXXXXXXXXXX-XXX-XXXXX----XXXXXXXXXXXXXX--XXX-XXXXXXXXX--XXXX-XX--X-XX-XX-XXX-XXX-XX-XXXXXXXXX-XXXXXXXXXX
