----------------------------------------------------------------------------------------------------------------------------------------------------------------------------BMM?||T?|-TX||B-Xo??E?MX-Bo-
----------------------------------------------------------------------------------------------------------------------------------------------------------------------------?MX?-MooMBTM-XXBXoMMEoMEo?|-
-----------------------------------------------------------------------------------------------------------------------------------------------------------------------------BToTME-Eo?BoB-BBooT|X-?MB--
----------------------------------------------------------------------------------------------------------------------------------------------------------------------------|BoMBo|B?TE|BX??-XX|XToE?oM-
----------------------------------------------------------------------------------------------------------------------------------------------------------------------------oBooToX|o-MBMX--??EX-|ToT---
----------------------------------------------------------------------------------------------------------------------------------------------------------------------------|?oo?--ETTBEoMMXMTo-|MoXXX|-
----------------------------------------------------------------------------------------------------------------------------------------------------------------------------M-ToBE-oMBTo?EXB|XEB|oMo?---
----------------------------------------------------------------------------------------------------------------------------------------------------------------------------oEB?-M?XB-B|TTTE?|BMB-o|-T|v
----------------------------------------------------------------------------------------------------------------------------------------------------------------------------oXE|XE|BBE-BX?B-T-X--T-EXTof
----------------------------------------------------------------------------------------------------------------------------------------------------------------------------EME||oooXTT?|-X-?XEB|?T-ooTf
----------------------------------------------------------------------------------------------------------------------------------------------------------------------------T-M?oM?TEMMTM??XEX|BM-|EE-Bf
----------------------------------------------------------------------------------------------------------------------------------------------------------------------------|BTTX|TMXEEooX-MEEBE?||XBBTf
----------------------------------------------------------------------------------------------------------------------------------------------------------------------------X-?|T?TT|X?EEMXTTETToE|BTBXf
----------------------------------------------------------------------------------------------------------------------------------------------------------------------------oE||?E?o?-TE-|?|?|o|X|BTX?of
m---------------------------------------------------------------------------------------------------------------------------------------------------------------------------oo|BXE|X-oMBXoT-TXT?T-EMETBX
XXXXXXXXXXXXXXXXXXXXXXXXXXXXXXXXXXXXXX-XXXXXXXXXXXXXXXXXXXXXXXXXXXXXXXXXXXXXXXXXXXXXXXXXXXXX-XXXXXXXXXXXXXXXXXXXXXXXXXXXXXXXXXXXXXXXXXXXXXXX-XXXXXX-XXXXXXXXXXXXXXXXXXXXXXXXXXXXXXXXXXXXXXXXXXXXXXXXXXXX
