E-ET?B?-B-B--M--M-oM|XoB?-?T-T-E?oXM-oo-oX|-M---XMXE--?EX-T|oBoo-E-oXT-EEoM-Too|EE?M?TEX-E-M-Eo?EBo|EE|||-X--||-o-X|-|-BE-MTT-EoX-ToBM||-|--XToX??X?-|X--XT-o||B--BBMMX?--?oMo-o----??T----X-M|EMEX-M-Eo
o-|BEBX-X-o-MB--M-|MXXB-o-X-MB-EB?BE-XE-EEoMM---BB|X--X|o-XBTT-o-M-oE-TET??T?M|M?-?--?T|XE?X-EToXoBTE?XoE-M--|M-T-?oBT-o--X?XMTT|--B|X?ETT-|EoBMBTM|-?ME-Eo--B-o--Xo|?TT--|BE?o---T-oME--E-E-EBo??T-o--M
T-oBXBE-X-B-?B--o-|EXMX?B-BEoM-XBTB---M-XEM--B--MBTB--EXB--TEBMo-M-oTMTE-|?XoT?M-M-MB|ME|||B-|B?BoBTXoEoE-T--o|-o-?MX?-TE-?-M?TTo-XEooM??|-MBoMT?TXM-B|T-M?-T-T?--oTX-M|--M-T|X|--|-TBX----M-|-?-E--|-?-
E-EEE-M-B-E-?E--E-MTTXE|B-|-??-|MTTM-|T-XMBEE---B-EE--M?--BXMTMM-E-EE-TE-TooBEBM-BXXMo|EXBME-EE|?-TB-M?T--X--T?-X-|MBB-Eo-MT|XBME-MX-o?T|B-||T|B|TX--MXT-o?-XE|?--X--BT?--??-EBT--X-BTXX-|-B-M??XX?-o??B
|-?BTTE-?---BB--o-?EBTMoM-ETo?-|T--o-?T-XXE|-o--M-|---M|o-?E-oXT-E-Mo??|EMEETB-B?-?TE|?oEoET---E-o?-X|Eo|----XX-o-|BE?-XT-|ooo?TE--ETo?MEM-?XBTXMB?B-XXM----|?----MTo?T---BB-E?X--o-XMB------E|?-oo-T-M-
T-X?B?M-?-?-oT--M-T-BEM|E-B?M|-??--B-oT-MXMBEE--E-TM--o?o-|TB-B--E-?BT?-TT-MBXXETBTo-BXMXo?E-??XBoBBTB-MX-?--B--T-X|oB----||TXoBX-BM|M?|B|-Mo|TM??-E-XEB-XT--EX---|EBMTE--X?M-oM--E-TXT--B-o-?XBXXo-T-Xo
T-XXE?M-M-T-XT--o--XB?TXT-MX-T-T?oXX-BX-|XEXM---X-BM--?|o-EE-|Xo-?-M-|-?B?M-XTE?X-E|TM-T?oT|-B|X?B||M|o?|-?--EX-X-MB|X-XM-E-?TE?T-ET-ETM?T-oMMB|?X-|--To-o?--XBM--XMMMoM--ET?EX---?-E-|--B-X-E?X?|E-E-oM
X-XEo?|-|-o-?E--?-M??X-?|-TE-?-?TX|M-o?--ooTX---B--o--TEo-BTE--B-?-??B||TB?-|o?XBTEoo|MEXo-----TXEM|XT??T-E--|E-|-?ME|-?B-M|MBBT---EMBoXB--TMETTME-|-?oB-BB-T?|X---oET|o--EX?o?o--o-XTo--B---EBT?MM-?--v
o-E?M?--E-B--E--o-BoBTXMB-X?-?-oE--o-|X-?-?Eo---XEXE--EM?-?X|XE--M--Eo-?o|-|ToB-BXo??EBXB|M--BE|TTBE?XM?|-|--MT-|-?T?B-M?-EXM?BTB-o-?oo-EX--?||MTX|E-EET--X-X-Xo--?TBXEM--TTT?M---o-BEB--E-B-BBEBMX-|-TB
E-XXMo--E-X-|---|-E?-Mo-?--Xo|-MoEXM-XX-X|XMTo---E-X--M-T-?M-o-X-E-|T|MTo-?-BX--?|TM-|B|??-T-?TMBo||MEo|o-o--B|-X-EE|o-oX-|XBXBXB-o|?ETT?X-o?X||?oBM-EXo-oo-?|E?--ET-To?--|?oE?|--?-MM|--B---M---B--M-?|
T-?-|?T-X-M--B--X-oM|?TTX-TMET-M?TBM-TT-o?TM|?--BT-E--ME?-EXTE?|-B-TME?BTX?|MMTBTEMB|XMMT|E--|-|T|B|MTTX|-|--|X-o-X|MB-M|-|MoToMB-EE||TMB--EEMXE|BB|-oMT-|B-|MBE--ETB|?M--Xoo?TT--o-||---T-M-M?XoBo-X-XT
T-TX|X|-E-|-ME--o-XTXEoo--M-BX-XBTE--E--T|XTBX--?ooB--TMM-MB?o|M-E-E--?-?-MX|EEBXX?o?EMBBXBo-TTT|?TM|ooXT-B--|o-B-TXoo-o|-oo-BEBT-TX?B|?oM-EEXEBEoo--||M-??-BXT|--?|MTMT--XoMoT-----X|M--o---XT|-E----oM
T-MT|B--T-M-M-----Bo??oM?-XT?E-MMo-|-BB--M|B?|--ME|?--ETo-EMEBMX-|-?o-|MTMoME|-BEX?oo-B??oM?-XBM--MoX|ooX-?--M--E-XMoM-XB-|XE|MT--XTX-EX?M-Eo-T???|o--M?-oE-T-oM--?X|ooM---oo?|E--?-T?---M-o-|||-XX---o?
X-TM|??-X-|-XB--E-MMEEME|-?M|B-?-BT--XX-MoX|??--?|M|--o?o-BT|XoM-T-TTEoM|MB-|BM-BMTE|-E?BXo--|-BoTBBXBoXE-o--oB-B-M--T-o?-EB|-oMB-EBX-o|TT-o?MTXMMT--ET?-??-ooE|--TXXM|---o?oBEM--|-EXT--E-o-|T|?M|---BB
m--M?|X---B-?M--T-EBE?|-?-TTM--EXMXX-MT-BoEMX----T|T--B|X-?oMT-|-M-X???TMM?BXBM|BE||XXEoXTB--|TM--oTTEEoT-B--|E---MT||-|--XEo?M|o-MBEXM-EX-|-EE?|MTX-EBB--T-X|TM--M??|oE--T?-?BM--B-T-T--M-E-o|-M?T-X-X|
XXXXXXXXXXXXXXXXXXXXXXXXXXXXXXXXXXXXXXXXXXXXXXXXXXXXXXXX-XXXXXXXXXXXXXXXXXXXXXXXXXXXXXXXXXXXXXXXXXXXXXXXXXXXXXXXXXXXXXXXXXXXXXXXXXXXXXXXXXXXXXXXXXXXXXXXXXXXXXXXXXXXXXXXXXXXoXXXXXXXXXXXXXXXXXXXXXXXXXXX
