--X|B?---E--??-X?-EE-M-EM||-TM---B-ME--BM?|M||?E---BBMM-o--?|-BoBX-X--|-B-M|X--Too--B-XB|?B--X?-M-oEB-M-?-o--|o?|---?--M-T?XE-o?o----X--XX-E-----M--TT-B-BBo-MoooX-?B-??-TTB--oX?-BBoE-|?o---M-EMTX--o--
---B|----B--XBMoT-?o-oX-MXo-B?|----T|?-MBooE-BBM---oMXM-----XEo?T|-X--M-|-EM----To-Bo-ToE|--TB|-X-EME-?MM-X--?-BT---?----E-EM-M?E----E---|-o----o?--oT---ToT-E|MoX--B-ToMX-?--MXB--oTM-o-MB--M-||-B--X--
--M|BM-E-|--E?E-X-ME-BE-BMX-o?E--E-XEB-E|XoXXBoE---MoTT-|--E--?TTE-?--?-?-M|E--Xo|-o?-TEXM|-EEB-B-TTo-T-T-B---ToM---o--?-M-BX-|TE-------||-M----BB--BT-|-?Mo-oo|?X-?--B-B|?E--XEB-E?TM-XETB--?-X?MB--B--
--XBME-E-X--E---M-?--M|?-----??--X-EE|-TT|EMM-|E---MXEo-E--ToMTTo--X--|-E-?MT--EBX-MM-EE?EE-|oB-E-??T-MTT----?TT?------o-E|----XM----o---|-X----X?--BT-X-B-?-B?MTT--T--MMMXT--?oB-X?|M-X?Eo--T-TTMM--?--
--?o?T-E-T--?ETET-|--XT?MX|-EB|----BE|-oEB??BX?M---|M|M-X--oBo-oX?----o-M-BXo---MM--?-Bo|oT-XEo-|-Bo---M|-M--oEo|---X--?---XE-oT-----E--T--B----M---?M-T-Too-E-?EB----XXoM|?--??B-EXEX-EBX---B-oTo?--?--
--XX-?-M----|MT??-oX--MBToE-?|X--?-??T-ToM?B|M?M---XBTM-?---oXBETT-M--|-M--M?---BX-|?-TB?XM-|E?---MXT-E?T-E--B|??---o--M-M?Xo-B?T----M---|-E----oE--o|-E-X?--M?|XE-BE-XB-oT?---X|-MEEM-?BME--B-?T?M--o--
--E|E?-o-?---oBM?-oE-MB-?BT-B-X--|-oTM-X???MEo||---?-Xo----T?ToM?|----M-X-XM?---?o-?E-BB-MX-EBT-?--B--o?--M-----?---?--E-MXX|-T??-------Mo-E----Mo--MM-B-E|--EMEEM-To-o?EBT?---?B-?-E--MB?E--B--Xo?--E--
--|MEo-B-o--MXM?T-XB-?M|-|?--MT--|-MME--BEToMBMM---TE-E----XTETT?E-o--?-T-TBX---B--XB-?oBB?-|BT-B-XMT-MTE-B--?EBM---o--E-TTTE-|EM----o---M-E----ET---o-o-|T?-E??XX-EX-B|EoX|--MB--M?|?-BMT|--M-M|----o-v
--?BXo------?TMT|--X-|oM?X?-B?o--E-M|B-TT?oB|BTT---EBo|-E--M|BE--o-B--T-M-o?B--MBT-o?-oXT|X-ETE-B-MMo-oE--T---?Eo---?--?-BBTo-Xo|----M--?T-E----?X--MX-?-XXB-MXX?X-?|-EBXX----Eo|--?E--BEMo--B-ET?M--|-f
--X--B-E-B--EMoEX-EX-T?XE-E-?Mo--X-EXo-XoTEEEEM?---?XXX-B--?--MEMo----|---TTM--T-M-TM-?ToTX-BTE-T--T--|-B-T--E-TT---B--o-o?E?-||X----M--TT-o----|o--B--X-|-B-BE||o-M|-|T?-?M--oE--??-B-|-?X--X-E-?B--|-f
--T--X-o-o--XEE|M-E|-MoBE|E-X-?--T-|oE-Too|BoET|---??B------BMEBXo-o--M-o-MMM--M?E-oT-TXEB?-BTX-T-?MB-BBo-B--XMoT---M--E-TEMM-XM-----T--B--o----Mo--X|-?-MTE-MoMEM-ME-M|--TE--BXM-BMMX-B|?|--E-XoE?--E-f
--|-M|------BBM|X-|X-?ME|o?-ooB--M-TB---BXT-XMo----ooMB----?MT|M|?-o--X---?Xo--MMT-|o-TMX---|MM-T-?M--|?M-E--?|oX---T--M-oE-M-|TM----|--M?-T----BX--XE-|-|oM-MMoE--T|-o?BMT|--XM|-M?M?-||-M--|-XEoE--T-f
--E--|-|-|--E--T?-E?--EETMB-|?---?-XoT-E--o|oEo|----XMT-X--?XE-BBX-M--?-?--B|--X?M--M-BM-M|-TE|-M--|o-?oE----M-??---|--X-?TBT---|----M--o--T----ET--M|-B-BXB-o--TB-MB---TXT|--E?E-X|T--TToM--E-TXXM--o-f
--|XEM-X-E--ME||X-XX-?EXT|o--EM--X-E|E-oX?MTE-BM---XEo?-X--???oEoo-o----X-M?M---XM-M--?ToEB-EoB-M-TBM-|BX-T--oMTE------|--M|o-BT?----X--E--E----oX--TT-?-|EX-?BM-|-oT-MBM|EX--TB?-?|TX-T-?M----E|T|--E-f
m-T-|?-T-E--XXBE?-?--TX-TTT-MT|--?-EEE-TE-BXEoTB---T?||-M--BTET-ME-B--|-B-XMX--MTM-oX-|B|MB-oMB-o-ET|-M-?-T--MT-o---B--|-MME?-M|?----E--|X-T-----M--oM-?--MX--Xo?o-?o-T?To|?---?E-?|-?-T?B|--?-EB|X--o-X
XXXXXXXXXXXXXXXXXXXXXXXXXXXXXXXXXXXXXXXXXXXXXXXXXXXXXXXXXXXXXXXXXXXXXXXXXXXXXXXXXXXXXXXXXXXXXXXXXXXXXXXXXXXXXXXXXXXXXXXXXXXXXXXXXXXXXXXXXXXXXXXXXXXXXXXXXXXXXXXXXXXXXXXXXXXXXXXXXXXXXXXXXXXXXXXXXXXXXXXX
