-ME|TEX?MoToB?-?E---|B||T-o-|----TT|-X?M--o---XXT--XE|T-EE--M-EEXX--|-M-|M-E--?XT|TM-T--ME--B-oB?o-?BXoTB|-?-oX---TB-M??-o-oXX-|MXMBE---|---XT-XB--E?o--E-?EEX?T---oETo?oMToB-o--B-?BXE-?BTTo?B|---o?B--
-?T-TXE-T?MEEM--M-?o|||||-E-B-TXB-T--BX|---T--|TBo|X??M-BBoE-TXooM--MB-MoT?|M--TXXTo-X--T----X|ME-B|oXoTTo-XEBXX--M|-EM--X-B|?-oE-|--TB-T-oM|X-BBBMooT-?XB||?o|B|-XXM-B-oEo-B--E|?-E?o?--BT|Eo-----MoT--
-EB|B?o-T?oMT?B-----XTXXX-o-o-MoXo-M-?Xo---|--oEEE?T|T|-M--?-|T?oB--oXTToX-EX-M?Boo|TB--M|---B--EEEo-oBE-M-oBXoE--?--XEE-B--X--MTM?BB|--X-M|XoEB|-|-|--T||MoM|-M?-B|XBMTE-|?X-B-BT--|-|-ME-oEE-o----BE--
--?|?--X-BB??M|-T-MM-oMMo-X-|--?M--T--MX--TX--B-BE||-??-MoE-EE|EEE--||?BT-EXM-o-TMM|-o---BM--EoX-||o-?M-??-MB-M---oo-ToX-?--TT-B??EBoX--B-Mo?-MXMT?oo|-BTXTTEo-TE-MXoo|M-M-T|-B-|E-oTMT-TTTEEB-o--BE-T--
---?MX?o-?TE-|M-X-E-EB?-B---?-T-XE|X-MT?---X--M-ME--oXE-X-TBETBBX---T-|-E-T-T-|-E-T|-T--E---BoTM-To-XoXT??-E|TTo---o-XX|-X--BM--MBBM?|--o-TM?-XX|MXo-T-o--X-|MM---EE|B--?--EB-B-?E-E-?o-XT|-o--E--X||o--
-ME??|X-M?|TTX--E--XX-??M-X-?-B??-E--BEo--B?--EXTXB?B-X-o---Mo--XX--?TB-MTE---BM?||o-----??-Eo?oX-EXMX|E-|-?E|E|--XT-?EX-o-|TX-M|-XEM|--T-|o|--BBBXE|X-B|T-BE|EBT-M-o|-X-o-MXXB-XM-MEoX-ET|TTT-M--oBXM--
-?ooB-TXTEoBT-X-M-|EM-E??---M-|EBX---XE-X-TT---MXo??Xo|-oB-TMoX-|B--BX-?EMEMM-?E?EB--?--|XT-?|o--MEE----M?-BoEoB--|?-MEE-M--ME-X?-MEE---?-TB-T-T-EoB|X-M--EB?oBEM-TMM-XB|-EMB---?M-EETB-o?E--E-----X?---
-X?---o?ETMM-?--M-E?-T|MB---T-|X?B?o-ETM--|---XMMoMM-?--MX|-oXX?ME--X?-??M|M---o|EB-----|-|-|---ToTBBMoM-o-MBMEM---X-|Eo-?-T|?-BT--M-E--B--T?X?|TXT-o--E|o|T--MT|-EooM?T-E?-|-|-E--T||T-M|XBMM-B--?EBB-v
-|MXoX-oB|XXT-|-X-X-?o|EoX-M|-BBB-BB-ooT--BT--T?MTBME?--MXooooB?B|--|--E-XoT---XE--X----E|B-T|?o-B-EoM--Mo-BMTTX--B---|E-M-o|TT--BETB---X??M-To?Xo-??B-Eooo?oo-?E--E?TM|BTB-E-E--?-oX-o-|Bo--o-|--|BM?-f
-X--|-|T--E|-oo-T--|oEB?o-B-?-TMBTo|-BM?-XXM--T-XBX-MT--|oXMXE-?X---oT--ET??X-X|B-ME-B--XoT-MTE?XT-TTToXTE-?oME?--oE--M|---XM|--XoMoE|----ooME-ME??BB?-EM|BT|-??--XM-TBX--M|E-?-XE-?-X-EXoo-|X-|--EEo|-f
-?MB|X?ETT-X|T?-|-X|-EE??---o-M?XME?--oX--?|--o?MX?-EME-|M?-E|-|?B--???XT|-?-?TBB?XM-o--XB--oMTMTE|-|ToX?E-oMooo--Eo-M?--B-|o?--EM-MM---T-B|BoTo|-TXo|--E|-??BME?--o-M?|MM||T-o-ET-|M|--?|?M-E-B---ME-Tf
-|-ET-EEX-ooMTB-X-XEBXXEX-----M-EX||-M|E--XT--oBoMETBB?EBT--TTT?BB--T-TXB|BBT-XE-?|M-?---X-TX-?EXTEXEEE?-|-B?oT|--?B-B-----X-?oM?XM|-M--X--|-B||TTo?EB-Bo|E-||-BT-B-X-BoBTT|X-X-BE-MB-T-TE-BoE-X--EToE-f
-BET??TXX?oo?---|-|--oM-Eoo-E--oTXTT-EB|--oE--|o?-?XT---T|-M?oo--M--MBoBoB--X--ETE|M----o-T-E-XoXoBXMoMMoo-X-TM|--TE-|oE-E-MX----|?B-B--M-BEE?BX-TBM---MT-|M?B?|X-M-??T---oX?-T-?E-BooT-B|MXBX-B--M?-?-f
-TT-ooBET??o?-X-B-??ET|?B-?---EXoBo|---T--oT--oo--To-MT-MM|o|M-?B----oTT?T?EM-T-??XT----ETE-E-B|-BXXX-XB??--X|oE-XE|EX-M-B-MT|-Bo-TM?X--E-TXToT?|T|M-B-EXooX??-ET-|BTBToXo?MM?X-|X?oEEM-|?MX-|-X--MBXE-f
mXXT-XB-XTXTBEB-M-BEBo-oE-E---MEB-TX-E?---?B-oM-|T||oBM-BT-BEBT--?--X-??-XoMX-ET??XX-X--?M--EM-MooT?X?TMX|-?-E-M--Bo-oX-----E---|M-M|T--?--XBMoooMXX|T-X?X?EEXTE--|E?|?B-T-?|-E-X--X-?o-MX-TME-T--X-X--X
XXXXXXXMXXXXXXXXXXXXXXXXXXXXXXXXXXXXXXXX-XXXXXXXXXXXXXXXXXXXXXXXXXXXX--X--XXXXXXXX-XXXXX-XXXXXXXXXXXXXXX-XX--XXXXXXXXXXXXXXXXXXXXXXXXXXXXXX-XXXXXXXXXXXXX-XXXXXXXXXXXXXXXXXXXXXX-XXX-XXXX-XXXXXXXXXXXXXX
