-----------------------------------------------------------------------------------------------------------------------------------------------------------------------------?ToEMBE-?MTMMXXTXo-MXMX?M|-
-----------------------------------------------------------------------------------------------------------------------------------------------------------------------------MB--XT-|XXoo-o?T-|X?|oMTB--
-----------------------------------------------------------------------------------------------------------------------------------------------------------------------------|-oEM|MT|?T-oE|T-||MTXEoM?-
-----------------------------------------------------------------------------------------------------------------------------------------------------------------------------EoT?B|o|TTT|E?EE|-?BM-MoE--
-----------------------------------------------------------------------------------------------------------------------------------------------------------------------------?TM?-B|B|MX-MoBo-EEoT?XM---
------------------------------------------------------------------------------------------------------------------------------------------------------------------------------EEo|?T?|-M|o-X|?EoE?-E?-B-
-----------------------------------------------------------------------------------------------------------------------------------------------------------------------------|E||-|oMB-XXB|XT-X|o--EXM--
-----------------------------------------------------------------------------------------------------------------------------------------------------------------------------BMTXTo|X?B-MXB?||MoE--BBo-v
-----------------------------------------------------------------------------------------------------------------------------------------------------------------------------oB-MoXMM-X-oET-|-MoBT-E?-?f
-----------------------------------------------------------------------------------------------------------------------------------------------------------------------------XTMTE|o-XoEE-|--XEE--ETXBTf
-----------------------------------------------------------------------------------------------------------------------------------------------------------------------------X?oB|-E??-?-M?BE?X?|-o?T-Mf
-----------------------------------------------------------------------------------------------------------------------------------------------------------------------------?XM|METB-ME|M?X?Xo-M-|XT-of
-----------------------------------------------------------------------------------------------------------------------------------------------------------------------------EX---BEBE-Xoo-TBM|T-oB--|of
-----------------------------------------------------------------------------------------------------------------------------------------------------------------------------?M--??-X-MM|TM-|X?oTT---XTf
m-----------------X-----X----------------------X----------X---------------------------X----X---------X--X------------------X--------X-X--------------------------------------??X?|XoEETXo-o?-X||EXXT||XX
XXXXXXXXXXXXXXXXXX-XXXXX-XXXXXXXXXXXXXXXXXXXXXX-XXXXXXXXXX-XXXXXXXXXXXXXXXXXXXXXXXXXXX-XXXX-XXXXXXXXX-XX-XXXXXXXXXXXXXXXXXX-XXXXXXXX-X-XXXXXXXXXXXXXXXXXXXXXXXXXXXXXXXXXXXXXXXXXXX-XXXXXXXXXXXXXXXXXXX-X
