--------------------------------------------------------------------------------------TB|oT-|?XX|B------------T-----------|-----------------------------------------------------------------------------
--------------------------------------------------------------------------------------?oETBXB|?Eo------------?|-----------T-----------------------------------------------------------------------------
---------------------------------------------------------------------------------------o-E||M-o-MM----------TXB-----------?-----------------------------------------------------------------------------
--------------------------------------------------------------------------------------BM?-o||X|EXB------------------------?-----------------------------------------------------------------------------
--------------------------------------------------------------------------------------?-Mo?MBXMMTM-----------ME-----------|-----------------------------------------------------------------------------
--------------------------------------------------------------------------------------BEM-|--M-X|------------XT-----------E-----------------------------------------------------------------------------
--------------------------------------------------------------------------------------T|-MoMXE|XoB-----------XE-----------?-----------------------------------------------------------------------------
--------------------------------------------------------------------------------------oT??B-EBE-EX-----------TE-----------M----------------------------------------------------------------------------v
--------------------------------------------------------------------------------------E--|BMMXETo------------M?----------------------------------------------------------------------------------------f
--------------------------------------------------------------------------------------|XE--?--TM|o-----------?B-----------X----------------------------------------------------------------------------f
---------------------------------------------------------------------------------------|-X|MXEToB?-----------ET-----------o----------------------------------------------------------------------------f
--------------------------------------------------------------------E------------------BXoEET--BTE-----------oE----------------------------------------------------------------------------------------f
--------------------------------------------------------------------------------------B|MT-BE-o-X|-----------Bo-----------E----------------------------------------------------------------------------f
--------------------------------------------------------------------------------------oM-|TBE--|oX-----------M|-----------T--------------------------------------------------------------------------M-f
m-----------X------X-------------------------------X--------------------X-------------TXB-o-BoBX-T----X-X----EE-----------o------------X---------------X------------------X----------------------------X
XXXXXXXXXXX--XXXXXX-XXXXXXXXXXXXXXXXXXXXXXXXXXXXX-X-XXXXXXXXXXXXXXXXXXXX--XXXXXXXXXXXXX-XXXXXXXXXXXXXX-X-XXXXXXXXXXXXXXXXXXXXXXXXXXX-XX-XXXX-XXXXXXXXXX-XXXXXXXXXXXXXXXXX-XXXXXXXXXXXXXXXXXXXXXXXXXXXX-X
