-XXX?|-E-M--??-X--EEE-EEM||---??-o?EM--BBB--B|?E-X-|-EM-M-ME--ToBX-|----|-|BX-E-ooB-o-XBM-?EBX?-MTTB?-X??--?-|MXo----E-M--oXTX-|o----X--B--E-BB--|T--T-|-?----oBoX-?B-?--TX|T-oX?-TTT?--Mo-B-M?BEEE--X--
---EB--?-T--XEEo--?oT-E-MXo---E--TMBX--MXX|-BBBM-o-|-BM-|-?--ET?T|-M----B-Eo--E-ToT-T--oo-BX|B|-XoBXE-TBM--o-BoXMX---M----TETE-?E----EE-o--T-MM-oE?--T-B-|-M-E|ooX--B-T--XoT--MXB-oEBM-XoM-B-MX-?Eo--o--
-TM--T-o----||o---MEX-o-BMX---o?-|MoE--EMMB-?BoE-?-M-?T-?-EM--MTTE-o----X-X-E-o-o|M-B-|EX-XB|EB-BBToo--TT--o-oMBoE---E-?--|B-E--EXM-----B--M-X?-BXX--T---T-T-Xo|?X-?--B--|TTE-XEB-BB?--XXT-X-???-BM--|--
-?XMoT-B-T---MX---?---B?------BB-X?T---T|-X-B-|E-E-o-|o-?-B?-MTTo--E----?-oTT-T-BXo-|-MEE-o?-oB-EoX?X-|ET--X-MEXMM---B-o--B--T-?MB?--oX-E--T----XBB--T-M-B-?-E?BTT--T----MBT|-?oB-To---?TE-|-TBoXEB--o--
-|??Eo-?-T--T?oE--|-o-M?MX|---M|-T|Bo--oM|E-?X?M---B-oM-M-||-oMoX?-?----|-oTo---MME-E-|o?-XE?Eo-|B-E?-B?|--M-??XE?---|-?--|XMT-B--o--Eo-T--M--T-MTM--M-|-E-|-?-XEB----X--MMBE-??B-|MM|-?oX-X-BX|X?M--X--
-MXoB?---o----E?--oX--EBToE---oE-BT|E--TM??--M?M-M-?-oM-B-|o-XBETT-X----|-Eo?-T-BX--M-XB|-B|oE?--T|M?-T|T--E-BBETE---?-M--TX|X-XTo---MX-M----?X-o?o--|-B-M-M-E?oXE-BE-X--o?-o--X|-?-EX-XXM-X-B?ooT|--|--
-BEM?|-?-B---MMM--oEB-B-?BT---X|-oEEo--XT---oo||-X-|-To-M-oX-T?M?|-X----o-M??-M-?o--|-oBB-MMoBT-?X|EE-||---X-M?T|X---?-E--TXTE-E?|----M-?--T-T?-MoB--M-o-B---MMTEM-To-o--BX?X--?B-?X-T-E|?-?-BXBo||--X--
-?||T--B-B--?TT?--XBE-M|-|?---oE-TXBE---E|--oBMM-B-B-|E-E-EE-EBT?E-M----X-XXX-?-B-----BoT-XBoBT-BXT?T-o?E--o--MEBo---?-E--XTX|-BM?T--o?-B--T-B--ET---o-E-E-E-T?-XX-EX-B--oToo-MB--|ETE-oBT-o-MME|XE--T-v
-o?MXo-M-E--T?XT---X|-|M?X?---|o-E|XE--TX-B-TBTT-X-|-E|-T-XE-BX--o-o------||B---BTM-T-XXX-|TMTE-B??---BB---?-MEE?T---M-?--MTB--?|B|--M--M--|-Bo-?o|--X-?-M-X--X-?X-?|-E--XXo?-Eo|-X-o|-|oM-X-BEo|oM--T-f
-?XTBB---X--M?|E--EXE--XE-E---?|-TMoX--X--E-XEM?-X---EX-|-?B--|EMo-?----T-|XM-T--M|-B-?TE-BX?TE-T??MB-?EB----XBB|T---o-o---EEE-BXEB--ME-E--M-|T-|Mo----o-|-X-?EM|o-M|-|---XoM-oE--Eo|?-?T?-T-XM|oXE--M-f
-XTB|T-|-X--oXE|--E||-oBE|E---?E-?|ET--TEEM-oET|-?-|-M--B-EB-MBBXo-X----M-T|M-X-?EM-B-EX--|XETX-ToXET--Xo--E--o?E?---M-E--?MM--E-TT--T-----M-ET-MEo--|-X-o-o-|ooEM-ME-M---T-E-BXM-MXoE-oB?-T-E|?M??----f
-o|ME?-X-?--?-||--|X?-ME|o?---ET-oMX----XXE-BMo--?-B-EB-|--?-T?M|?-X----o-E-o-X-MTM-X-oMM--E-MM-T|-M|-?EM----??o?B---T-M--o-??-?M|M--|--M--o-|o-B|o--E-?-|-B-EMEE--T|-o--M?TE-XM|-M-o|--?--T-|oo-XM--M-f
-oE?MB-T-|---?MT--E?--XETMB---??-TM?E--ET?|-XEo|---T-BT-E-?--EBBBX-M----?-TB|---?MB-o-BMT-X|BE|-M-MT?-T-E--?-BEB-o---B-X--?B|o--||T--MM-B--E-EM-E?B--|-M-|-o-?-oTB-MB----XEXX-E?E-BB---BTo-M-E?oBTE--o-f
-?|ET?-|-M---M?|--XXM-TXT|o---MB-oX?T--oE?M-T-BM-?-X-??-E-o--?TEoo-E------|TM---XM|-?-oT---XBoB-M-T|M-TXX--X-oXXoo---X-|--E|Bo-E?X?--XX-T----M--o||--T---T-|-MBE-|-oT-M--|??o-TB?-|?TE-XB?-o---M?MX--E-f
m|TBo|-B-X--|-EE--?-B-E-TTT---ET-|B?B--TMoo-EoTB-X-o-X|-E-oX-EM-ME-o----|-ETX-T-TMo---BBB-TTTMB-oE-B|--M?--?-X?TME---M-|--ME?B-|?E|--EX-B--E-BE--?E--M-M-|-X-?XT?o-?o-T--oXE---?E-?-BT-BBB-B-?o|?|T--E-X
XXXXXXXXXXXXXXXXXXXXXXXXXXXXXXXXXXXXXXXXXXXXXXXXXXXXXXXXXXXXXXXXXXXXXXXXXXXXXXXXXXXXXXXXXXXXXXXXXXXXXXXXXXXXXXXXXXXXXXXXXXXXXXXXXXXXXXXXXXXXXXXXXXXXXXXXXXXXXXXXXXXXXXXXXXXXXXXXXXXXXXXXXXXXXXXXXXXXXXXX
