----------------------------------------------------------------------------------------------------------------------------------------------------------------------------------------X|B-EBTEB-M||oX-
----------------------------------------------------------------------------------------------------------------------------------------------------------------------------------------XoBToB|oo?o?|?|-
-----------------------------------------------------------------------------------------------------------------------------------------------------------------------------------------E?X|E?M?X|TEo--
----------------------------------------------------------------------------------------------------------------------------------------------------------------------------------------o|-|XM|?X|o|-XE-
----------------------------------------------------------------------------------------------------------------------------------------------------------------------------------------XE?MBEB-ME?T?|o-
----------------------------------------------------------------------------------------------------------------------------------------------------------------------------------------T-EXXXBB-?o?E?--
----------------------------------------------------------------------------------------------------------------------------------------------------------------------------------------|BX-M??XMXooE|o-
----------------------------------------------------------------------------------------------------------------------------------------------------------------------------------------B-EX??XM?--?BT|v
----------------------------------------------------------------------------------------------------------------------------------------------------------------------------------------T-|XM--o-?MMEBXf
----------------------------------------------------------------------------------------------------------------------------------------------------------------------------------------EoX-TXB-EMoBE|Tf
-----------------------------------------------------------------------------------------------------------------------------------------------------------------------------------------M|oMo??M?MToBof
----------------------------------------------------------------------------------------------------------------------------------------------------------------------------------------|-TET?MTTEB-EM-f
----------------------------------------------------------------------------------------------------------------------------------------------------------------------------------------BXTBM|MXoX--TX-f
----------------------------------------------------------------------------------------------------------------------------------------------------------------------------------------M-|EXXETo?T-XoMf
m---------------------------------------------------------------------------------------------------------------------------------------------------------------------------------------To?MB?-Xo|TM|XBX
XXXXXXXXXXXXXXXXXXXXXXXXXXXXXXXXXXXXXXXXXXXXXXXXXXXXXXXXXXXXXXXXXXXXXXXXXXXXXXXXXXXXXXXXXXXXXXXXXXXXXXXXXXXXXXXXXXXXXXXXXXXXXXXXXXXXXXXXXXXXXXXXXXXXXXXXXXXXXXXXXXXXXXXXXXXXXXXXXXXXXXXXXXXXXXXXX-XXXXXX
