--------------------------------------------o-----------------------------------------------------------o-----------------------------------------------------------------------------------------------
-----------------------------------------------------------------------------------------------------------------------------------o-------------------------------o-----------------------------B------
------------------------------------------------------------------------------------------------------------------------------------------------------------------------------------------?-------------
------------------------------------------------------B----------------------------------B-------------------------------------o-------------?-------o--------------------------------------------------
--------------------------------------------------------------B-------------------------------------------------------------------o-------B------------o-----------------B-?----------------------------
------------------------X--------------------------------------------------------------------------------o---------------B------------------------------------------------------------------------------
------------------------------------------------o------o------------------------------------------------------------------------------------------------------------------------------------------------
--------------------------------------------------------------------------------------------------------------------------------------------------------B---------------------------------------B------v
--------------------B----------X---------------------------------------------o-------------------------------------------------------------------------------------------------------------------------f
--------B-----------------------------------------B----------------------------------------------------------------------B----M--------------------------------------------B---------------------------f
-------------------------------------------B--------------------------------------------o------------------X-------------------------------------o---------o--------------------------o-M--------------f
----------------------------------------------------------------------------------------------------------------------------------------------------B------------------------------------------B-------f
---X------M----------------B---------------------------------------------------------------------------------------------------------------------------------------------------------------------------f
------------------------------------------------------------------------------------------------------B----------------B------------------------o-----------------------------------------------------Bf
m-----------------B---------------------------------o---------------------------------------------X---------------E------------------------------------------------------------------------------------X
XXXXXXXXXXXXXXXXXX-XXXXXXXXXXXXXXXXXXXXXXXXXXXXXXXXXXXXXXXXXXXXXXXXXXXXXXXXXXXXXXXXXXXXXXXXXXXXXX--XXXXXXXXXXXXXXXXXXXXXXXXXXXXXXXXXXXXXXXXXXXXXXXXXXXXXXXXXXXXXXXXXXXXXXXXXXXXXXXXXXXXXXXXXXXXXXXXXXXXX
