E?|--|o-X??-o?XE---?TBE-------EXM-?-M|-M-XE-|E-M?B??Mo-XoT--E-E---B-|o|-E-XoX?TXBTEB--?|BM--X-XEXEEXT----BBB-E--?-B|T?E-To-M|MET--?--ToMT-EBT--X-|-BMXTBM-X-?-o-M--oB|||---TT-o??TX--|-T--E-ET-??-T||B-E
-?Bo-XX-Eo?-TB|E---Bo?BoBB--B-?B?XB-MX-?|XM-XX-E?BXMMEoMoX--M-X---o--X?-?-TEXXTTo?E|--X-||T-To|T||MMX----TMT-E-BX-TEM?XXTBMXBM?---X-MEM?E-XoE--|-MBM?o|MX-M-XTMTE|-E|-|XT-T||--To-?--B-o--BoT|-MooXMBXT-
--Xo-|M-T-T---ET---B|?X-Eo--o-TB|oT-|T-E|TT-XX-BXMEMX?|X-|--T-----X-XBM-oT-?E|BM-||o--E?T||-M?|X-XB|E-----E|-E-??-MM-XT|oo|oTMET--|-XX|oT-|-X--T-T-To|oEX---EEXM?M-|Mo|MT-E-E-oMEoX--X----oBE|-BT?TEXETE
?oE--?X--T?-?oXM---o|?Mo-M--X-MXB?E-TM-XT?|-BX-o-EEEEX|TXM--?-B---T---X-EooEMXX??-B?--?Bo-o-|BT|M|T-E----BM?-|-|--MXoEMBTM|B-?oM--T--E?B|-XXT--M-|TXM-BE----TTXMTo-BXBTM|-oM|--|?|M--o-X--?-T--o|T|EX??E
-E?T-B|-|-T-T?-X----ET?-EE----o-E---XT-|?XT-TT--E-XET?-M??--M-?---?-|---|M|-?EBE-|?B--oEM|E-TXBEEMEX|-----X|-M-BE--?BTBB-TEBEXET--T-XEMB?-T|M--T--ooMBXBX-o-o?MTEE-|oXB||-X-M--?M?T--o-|--oT||-oX-MM|XXT
BME--BM-T-?-X-BB----BT?oMX--M-BET-T----oBX|-EE-o?oBXMTX?BX--?-M---X-BTT-|M?B??EB-?XB----XTM-BTTE--ETB-----ME-M--o-EMX?TTEE?oB|oB--T-EXTM|-MBX--T-ETT|o|T--|-XMT|Mo-oM?-TT-ETE--To?B--B-B--MBoT-o?EMTXo|?
XBX|-M?-|?o-XEMB---XEX-|o|--|-B|?Bo-M--MXo?-X--?TM?|o|||?X--B-E---o-Xo|-BoBXTT-o?oB---oEE?--B|Eo|T|BE----??M-T-?|-TB?X?X??o-?EBM--T-TX?M--BM|--X-EoMMo?TX-?-|TXB|E-|M?X-?-???-?MXB|--|-X--EEXo-BX|XEXBM|
|EXB-oT-XXM-T|-B---T?B-BX---?-oMT?|-|o-X-XB-MX-ET|EEX-?ooT----M---T-Moo-BET-ETo?EM-X--?|B---E|oEEETTT----|TM-M-?M-ETMM-XToB--EBE--o-TE|-|-o-T--M-o|T?BMB--T-BEToME-T-MT-X-EoT-TX?E---X-M--X?-E-E?-EX?o|v
TEXX-E--B-X-B|||---MXXMX-B----BTB-T--?-|Boo-XE-TBoX?XEoT?M--M-o---M-B|B-E??B|M-X-o?o---T?|M--o?|Mo?|B----EoT-X--|-?BXMo?o-?To?Eo--|-||MTT-??X--B-oo|?-|B?-o-E|X-X|-BTXXX|-?||-MEoBE--M-E--E-----XE||EEo?
oMXB-B|-MEB-Eo-M---X-|-MEM--?--?M-M--E-?XX?-?E-Xoo|BXM|T-B--B-|---|-XTB-X|B||X|X|B??--ToEoB-?TEXEM-?X----T-T-B-EB-oB?ETE?XEX?|B---|--T?-o-MTo--X-XB-BTBMo-?-BoXE|T-M?BETE-oB|-||-MT--o-?--T?||-|-|Mo--?T
oBoE-|E-M-?-Xo|X----EMMBXo--|-o-?|X-MB-|BTE-B--BoT|M|oBTBT--|-M---o-T?|-ooMo?M|BB--B--|-E-M-|ETTXTETX----XXo---EB--M|MT-XEETTE??--?-E?oEX-XX---?--XMM-To|-X-TEM-MM-T||?|X--Mo-T?-|---E------Bo--o-oM?--E
-?-?-Mo-TXX-E-BX---EoMoMM-----M--o?-??-To?|-??-TMX?ET-oEXE--X-o---o-EM|-|ToMMTX-BMXB--T-|XX--XoMooXTE----ooE---X|-|Bo|B-B-TX?Moo--M-To???-|-o--M-EX-EoM-M-?-X?TXXT--M??o|-?XE-XM-M?--?-B---M?X-??BTB|o|E
o|-X-T|-|?X-|o|----ToETTME--T--BToo-?M-ToMM-MT-|T???XoXBoX--T-B---X-||T-MT?-??M?-|BE--MMXoE-BT-M??BB|----E?T-o-BT-?MMXBTEMMB|TXB--E--T|BE-BE?--E-oTBEBo-M-|-?--EBB-oEB-|E-MBT-|oT-o----?--XEBT-XXX|BXM?E
-|-|-oT-?XX-o?MX---TTTXXo-----|XXEo----E|T--|?-T???X|-|MMo--|-B---?-EXB-TMEM?MoTBBBM--T--T--X?-X-X|B?----ME--E--B-?XEXMMoBMBTo?|--X--oM|B-TXB--T-oB||?E?T-E-B|?XB?--?X?ME-TEB-B|M-B--X-B--M|B?-XoEX-BB-B
mooM-E--BEB--T-|---oB??E|?--M-|MXEB-?|-||TM-X|-?TM--TXMoB---X-X---?-?|M-TM?Eo|?|MXoB--To?|M--o???oo-|----X|X-?-Xo-E|B-Mo?XoMBE----E-|TBXX--To--X-ooTX?TBM---EBEoo|-MTT-XM-ET?-E?EB-----X--XTE?-MBEXo?oXM
XXXXXXXXXXXXXXXXXXXXXXXXXXXXXXXXXXXXXXXXXXXXXXXXXXXXXXXXXXXXXXXXXXXXXXXXXXXXXXXXXXXXXXXXXXXXXXXXXXXXXXXXXXXXXXXXXXXXXXXXXXXXXXXXXXXXXXXXXXXXXXXXXXXXXXXXXXXXXXXXXXXXXXXXXXXXXXXXXXXXXXXXXXXXXXXXXXXXXXXX
