--------------------------------------------------------------------------------------------------------------------------------------------------------------------------------------------------------
--------------------------------------------------------------------------------------------------------------------------------------------------------------------------------------------------------
--------------------------------------------------------------------------------------------------------------------------------------------------------------------------------------------------------
--------------------------------------------------------------------------------------------------------------------------------------------------------------------------------------------------------
--------------------------------------------------------------------------------------------------------------------------------------------------------------------------------------------------------
--------------------------------------------------------------------------------------------------------------------------------------------------------------------------------------------------------
--------------------------------------------------------------------------------------------------------------------------------------------------------------------------------------------------------
-------------------------------------------------------------------------------------------------------------------------------------------------------------------------------------------------------v
-----------------------------------X-------------------------------------------------------------------------------------------------------------------------------------------------------------------f
----------------------------------XX----------------------------------------------------------------------------------------------------------------------------?--------------------------------------f
---------------------------------XXX------------------------------------------------------------------------------------------------------------------------------X------------------------------------f
--------------------------------XXXX-------------------------------------------------------------------------------------------------------------------------------------------------------------------f
-------------------------------XXXXX----------------------------------------------------------------------------------------------------------------------------------????????-------------------------f
------------------------------XXXXXX--------------------------------------------------------------------------------------------------------------------------------------------------?----------------f
m----------------------------XXXXXXX-------------------------------------------------------B------------------------------------------------------E----------------------------------------------------X
XXXXXXXXXXXXXXXXXXXXXXXXXXXXXXXXXXXXXXXXXXXXXXXXXXXXXXXXXXXXXXXXXXXXXXXXXXXXXXXXXXXXXXXXXXXXXXXXXXXXXX-XXXXXXXXXXXXXXXXXXXXXXXXXXXXXXXXXXXXXXXXXXXXXXXXXXXXXXXXXXXXXXXXXXXXXXXXXXXXXXXXXXXXXXXXXXXXXXXXX
