-XE----X-MTM-XTBB-XX|E-TT-B-M--|B---B-?-X|?EEE-|XMo?B|T----?T||-TTo-?oTX--E----?|--|-TE-TX?X|E-X-T-B--BBX---M?-||-------oE--X--B-E-T---E----?---T-EMM----|B--E?-E-?M|---|-X|---|-oB?-B-XBB-|-||-?-X|-M?-
--M---o|-E-B---E-oo-M--M|-E-X-M--BEMBBB----||E-EEo|-EMX-X---MMM-MEBX-E-|?-|X--oXX?-?--o-?XoTT--o?X-|--?TX---??EB-----o--XM--ME-T------X?-|-Mo-T--B-Xo-E-XXB--o--B|oT----X-ET-B|TE?MM-?-oo-MoBX-E|XB?-TT-
--T-E-T--X-M-|-||ME-EB--|-XB---X||MMB-?-M-XoT?-|-|-E|?M-T--|?Xo-|B-XEEBT?-M---T-TT-?-BT-XBo???---o-M--?X----BMMMo---?---Eo?-oB-E-B-X--M--TE|X-T--ETE|-|-?XT--oE-XBTET---o-XX--BTM||--E-???|-M??-|oMo-BM-
-|----ME-?TM-|ET-MoBoT-E|-TMT-TTEMM?B-T-T-|Xo--||B|o----MM-MoE|-ETM-M-?-|-X?--?--B-?-oT-|-|E-B-M-M-o--E-E---ETXTM---ET--|T---|-B-X-|--o|-B-T--o-E-X|T-E-------X-B-?-X---|-|o-X--?|X|-B-B?Too--E-?MEo--X-
-EM---o?-?-T-|?oMoMoXE-X-|??X-o?XXT|E-T-M--TX?---EM-M-M-XB-BET--?E|M--T?--|T--TT|B-o-T?-TooEB----X-T--BXM---BXM|T---TM--?-X-oX-B---?--o?-oXE--B-oME|E----|o--o|-?-XEB-----X?-MTX?-X|-o-ToEE??o?-TEMM-?|-
-EE---oB-||X-o|oXMTEXM--T--ET-BB-MXMB-T-?-EMTM|MMM-E|E|-MM-EM|?-TEEoX-ET--Bo--?|M--X-o|-X-|o?B-T-X-oE-X|B---ooXT?---XX----B-TT-T-?----o?-X-o?-E--B-Eo---M----?T-T-TB-|--T-oM-|B--BMB-X--|EEETM--??-o--?-
-BB---B--BM?-Mo|--o-EM-|--M-?-|MoXB-M-oXT-BEBB-T-TTBEB?-T|-|-Eo-EBEX-MBBo--|--oo|--B-??-B--|-X-M-?B---XoE---MMTME---MX--B----E-E-|-B--B--EMMM-B-M--E--|--X---XT-BB-|M-T-X--X-|-XX-XT----T|EEXEMTT?XT-|M-
-TB---?M-EEM-o|-MM-|T?-T---XM-?-EM|B?-T---oo?X---o?--T?--X-XMBT-|BET?MXB?-XE--o?E--B--T-MTBMBo-T---?-?--o----EBMT?---o--?TM-XB-E-E-T--o--?EMo-B-MTMEM-o-|E---?--Eo-oX---E-E--X-X-E|T-|-ooXToXBB-oTBB--Ev
-Xo---E?-|B--XEToBTE-T-|E-To---o-o-TT-T-o-XBoT-M-EMXEX?-|o-ET-X-Eo-EM|TB--oM--TEX--X-oB--BTXB?--------?XT---M?M|T--|-E--|o--XE-o-X-M--XX-oMEo-o-BM?o--B---B--M--ETBM|---T-|--M--|EB|-T-TM-??|TT-TEX|-M-f
-XX---X|-BT--|oTXETMT?--EE-E||T?XM-E--o-?-?oo--oMT-oB?|--?-MMT?-E-T?-XTTB--T--EM|M||--B-Eo-?o--|-E-|---To---|?T-----ET--M?T-|E-E-B-M---T-|T|T-?-Eoo-B-B-MoT--M--MMB?B---X-B--MBBTM|o-o-BEMB-EoT-oB-T-TMf
-oT---o--?|X--X?MBX-|o-??-Mo---?o-T?--M-T--T-E-|E-BBMoE-EM--?-E-MX-?-E|X--T|--M-?|-o-ET-MMME|?-B-X-E---o------E|----?B--ETT-Mo--T-----Xo-BT-M-?--B?BE-T-?Xo---o-oBE-o---?-TT---B?-BE-T-oEX?oMXX-T|B--||f
--E---oX-E||-?E?M?-T?o-XM-TEX-o?MEo-X-B-|--|BM--B|X-o-M-X|-Xoo?--|-MM-oMT-MX--oX?--?--X-XM|-|B-X-M-M--T-B---E-BMM---?B--X-|--B-B---E-EMoT-TXT-M-oEE-|-|-ETX--E---o-oE-----?M-MXM-M?B-B-MT-BM-T--|MX---Xf
-Bo---E|-X?|-EM-|?--|?-X--EB--X-X-To--B-T-B|-o-E--BT-TE-|X-?BEE-?E??oB-Eo-BX--BMBM---oo--Bo--B-X-?-T---oo-----BB|---??--?|?-MB-X-|-B--||-B|XT-o--B?E-TT--B?--EM-BXBM----X--o-T--o?E--?-TEoT-BET-M-Eo-TTf
-|T---?T-XM--||TB||-|--Bo-T|o-oooBTMo-E??-MMB?-Xo-M?--o--X-X?BT-B|ET-MT-T--?--??XX-??X--o?T?E|-T-o-X--MTX----o|BE----X--?oE-|?-|---M--Xo-ETo--E-||-X|-T-XMM--B|-TT|EE---?-|T-----Mo-ET-MB-MB||--EMBT--Ef
mBo-X-M?---E-o|XXT-T?T--M-|T|--?XoTM|-X-|-TM|E-EM|Eo-X|-|T-X|o--oTBMT-|-EXT---BEEB---XE-BoT-E--TE|-o---|E---EM??E----E---|-X|?---X----Xo-B-o|XX-oXXMM-T-oT|--BX-BX?-B--o--E|-|MTTTB|-M-M-BET|-o-o-XB-X?X
XXXX-XXXXXXXXXX-XXXXXXXXXXXXXXXX-XXXXX-XXXXXXXXXXXXXXXXXX-XXXXXXXX-XX-XXX-X-XXXXXXX-XXXXXXXXXXXXXXXXXXXXXXXX-XXXXXXXXX-XXXX-X-XXXXXXXXXXX-XXX--XXXXXXXXXXXXXXX-XX-XXXXXXXXXXXXXXXXXXXXXXXXXXXXXXXMXXXXXX
