--------------------------------------------------------------------------------------TB|oT-|?XX|B------------T-----------|-----------------------------------------------------------------------------
--------------------------------------------------------------------------------------?oETBXB|?Eo------------?|-----------T-----------------------------------------------------------------------------
---------------------------------------------------------------------------------------o?|-|M-o-MM----------T-B-----------?-----------------------------------------------------------------------------
--------------------------------------------------------------------------------------BM--o||X|EXB-----------X------------?-----------------------------------------------------------------------------
--------------------------------------------------------------------------------------?-Mo?MBXMMTM-----------ME-----------|-----------------------------------------------------------------------------
--------------------------------------------------------------------------------------BEM-|--M-X|------------XT-----------E-----------------------------------------------------------------------------
--------------------------------------------------------------------------------------T|-MoMXE|XoB-----------XE-----------?-----------------------------------------------------------------------------
--------------------------------------------------------------------------------------oT??B-EE--EX-----------TE-----------M----------------------------------------------------------------------------v
--------------------------------------------------------------------------------------E--|BMMXETo------------M?----------------------------------------------------------------------------------------f
--------------------------------------------------------------------------------------|XE--?--TM|o-----------?B-----------X----------------------------------------------------------------------------f
---------------------------------------------------------------------------------------|-X|MXEToB?-----------ET-----------o----------------------------------------------------------------------------f
---------------------------------------------------------------------------------------BXoEET--BTE-----------oE----------------------------------------------------------------------------------------f
--------------------------------------------------------------------------------------B|MT-BE-o-X|-----------Bo-----------E----------------------------------------------------------------------------f
--------------------------------------------------------------------------------------oM-|TBE--|oX-----------M|-----------T----------------------------------------------------------------------------f
m-----------X------X------X---------------------------------------------X-------------T-B-o-BoBX-T----X------EE-----------o------------X----------------------X--X--------X--X--------------X----------X
XXXX-XXXXXX--XXXXXX-XXXXXX-XXXXXXXXXXXXXXXXXXXXXX-XXXXXXXXXXXXXXXXXXXXXX--XXXXXXXXXXXXXXXXXXXXXXXXXXXX-XXXXXXXXXXXXXXXXXXXXXXXXX-XXX-XX-X-XX-XXXXXXXXXXXXXXXXX-X--XXXX-XXX-XX-XXX-XXXXXXXXXX-XXXXXXXXX-X
