--------------------------------------------------------------------------------------------------------------------------------------------------------------------------------------X-XooB|o-TooMEMXB-
--------------------------------------------------------------------------------------------------------------------------------------------------------------------------------------Bo?--TBET?B?|T?|T-
--------------------------------------------------------------------------------------------------------------------------------------------------------------------------------------X|TTEXMXM?E?XE|oE-
--------------------------------------------------------------------------------------------------------------------------------------------------------------------------------------oBE?XM-o-TXB??|-o-
--------------------------------------------------------------------------------------------------------------------------------------------------------------------------------------oTEME?X-|o--EX?TE-
--------------------------------------------------------------------------------------------------------------------------------------------------------------------------------------EEB|Too|-M-X?EEE-E
--------------------------------------------------------------------------------------------------------------------------------------------------------------------------------------Mo--E?TEME|?MTTXX-
---------------------------------------------------------------------------------------------------------------------------------------------------------------------------------------?M|E?-BEXBTXXT|Bv
--------------------------------------------------------------------------------------------------------------------------------------------------------------------------------------XMMEE-XTEM?oTBMX-f
--------------------------------------------------------------------------------------------------------------------------------------------------------------------------------------TXXTXXTBTEMBoXE?Ef
--------------------------------------------------------------------------------------------------------------------------------------------------------------------------------------oMB||B|ET|-TB?|oof
---------------------------------------------------------------------------------------------------------------------------------------------------------------------------------------XXoBXo-MX|TooTo-f
--------------------------------------------------------------------------------------------------------------------------------------------------------------------------------------|Mo?T-XXoTB-XXTE?f
---------------------------------------------------------------------------------------------------------------------------------------------------------------------------------------MBTE?M??BTB--B-Xf
m-------------------------------------------------------------------------------------------------------------------------------------------------------------------------------------M|EX?|Bo?EB?BEX-TX
XXXXXX-XXXXXXXXXXXXXXXXXXXXXXXXXXXXXXXXXXXXXXXXXXXXXXXXXXXXXXXXXXXXXXXXXXXXXXXX-XXXXXXXXXXXXXXXXXXXXXXXXXXXXXXXXXXXXXXXXXXXXXXXXXXXXXXXXXXXXXXXXXXXXXXXXXXXXXXXXXXXXXXXXXXXXXXXXXXXXXXXXXXXXXX-XXXXXXXXX
