----E--------------------M---------E-----------------------?--------------------------------M--------------------------MMo---E------M----B-------------M----------M-E-----------------------Xo-------E-E
|-----------o------M-----------------B--o-----E--X-B-----------------------X-E--?---E---------------------------B---------------M-M-----X-----------------------M----X----------------E-----MEE--X----EB
B-o-----------------o-------?-------M-----X---------------?-----------------o--------M---------------------------B-----------------------X--------M--?----------?-------E-----------------------------MX
T-o-------------------------B----------M------MM-----------X-B---o--------o--E------oM--------------EM--------oM------o-X-----X-----B----------------------------------E----------------------------M-TB
E----E----------B-----------------------------E--------------o------oE-----------------------------X----------E----B-----------------------------------------XX---------X------E---o------M-oE-X---o--XX
oo----EE------------B-?-----B------E----------------------M--------------------------?-----------------------X------------------------------?-?-------------------------------M----B------------------XE
X?-----B----------X--------------?o------X------------------X-------?-----B--------------------------------X--------o-------------E---------o----?-------------X-----------------------?--X------------|
M---------------B--------------------------------E-M---------------EX---B-X-------M--E--------------B--------------E------M--------X------o-o-XB------E------------------X----------------?--X-E------?v
?-------------B---E------------------?X---------------o--------o----------------------------------------X---E--X------X------------o-----------------------?---------M-------------X------------------BT
o----?---------------?----------------------E----------------------------?------E?-----X--E?--------------------B-----------o?--E-----------X---------------------------------------------------------TX
B-----M----------------X------------B--------------------------------------------------------------------------M--------------------------------------B-X--------E-----------------M-----E---------XX-E?
?---?----?----M-----B------------M-----------------E-------------X-------------B--E------B-----B----------o------?-?----------X-------B--------------------------B--E--?------X-----------------o-----oo
M----------X--------E--------B------------------------o--------E-----B--------X--E-----M--------B-B-------------B---------------------------------------?-------o-E--------------o-E---?-o-----E-BB--T-X
o---------------X----------------------------X-o-----------------o----?---------------B-----B-------E---------------M---------M-----------X-o-------o------------------E------------------------------BX
mX-------X-XMo-------------o---------XE---X-M-B--X-------------X---------B---------X--?--------X---------EM-------XX-------------X--X---X----------E---B------X-----X-E----------------o-----------B-X|o
X-XXXXXXX-X-XXXXXXXXXXXXXXXXXXXXXXXXX-XXXX-XXXXXX-X-XXXXXXXXXXX-XXXX-XXXXXXXXXXXXXX-XXX-XX-X-XXMXX-XXXXXXXXX-XXXXX-XXXXXXXXXXXXXX-XX-XXX-XXXXXXXXXXXXXXXXXXXXX-XXXXX?XXX-XXXXXXXXXXXXXXXXXXX-XXXXXXXX-XX
