--------------------------------------------------------------------------------------TB|oT-|?XX|B------------T-----------|-----------------------------------------------------------------------------
--------------------------------------------------------------------------------------?oETBXB|?Eo------------?|-----------T-----------------------------------------------------------------------------
---------------------------------------------------------------------------------------o?E||M-o-MM----------TXB-----------?-----------------------------------------------------------------------------
--------------------------------------------------------------------------------------BM--o||X|EXB------------------------?-----------------------------------------------------------------------------
--------------------------------------------------------------------------------------?-Mo?MBXMMTM-----------ME-----------|-----------------------------------------------------------------------------
--------------------------------------------------------------------------------------BM--|--M-X|------------XT-----------E-----------------------------------------------------------------------------
--------------------------------------------------------------------------------------T|-MoMXE|XoB-----------XE-----------?-----------------------------------------------------------------------------
--------------------------------------------------------------------------------------oT??B-EBE-EX-----------TE-----------M----------------------------------------------------------------------------v
--------------------------------------------------------------------------------------E--|BMMXETo------------M?----------------------------------------------------------------------------------------f
--------------------------------------------------------------------------------------|XE--?--TM|o-----------?B-----------X----------------------------------------------------------------------------f
---------------------------------------------------------------------------------------|-X|MXEToB?-----------ET-----------o----------------------------------------------------------------------------f
---------------------------------------------------------------------------------------BXoEET--BTE-----------oE----------------------------------------------------------------------------------------f
--------------------------------------------------------------------------------------B|MT-BE-o-X|-----------Bo-----------E----------------------------------------------------------------------------f
--------------------------------------------------------------------------------------oM-|TBE--|oX-----------M|-----------T----------------------------------------------------------------------------f
m-----------X--------------------------------------X--------------------X-------------T-B-o-BoBX-T----X-X----EE-----------o------------X---------------X------------------X----------------------------X
XXXXXXXXXXX--XXXXXXXXXXXXXXXXXXXXXXXXXXX-XXXXXXXX-X-XXXXXXXXXXXXXXXXXXXX--XXXXXXXXXXXXXXXXXXXXXXXXXXXX-X-XXXXXXXXXXXXXXXXXXXXXXXXXXX-XX-XXXX-XXXXXXXXXX-XXXXXXXXXXXXXXXXX-XXXXXXXXXXXXXXXXXXXXXXXXXXXX-X
