--------------------o----------------------------------------------------------------------------------------------------------------X------------------------------------------------------------------
---------------------------------------------------------------------------------------------------------------------------------------------o---------------------o-------------------B---------B-B----
------------------------------------------------------------------------------------------------------------------------------------------------------------------------------------------?-------------
--------------------------------------B-----------------------------------------------------------------------------------------------------------------------------------------------------------------
---------------------------------------------------------------------------------------B-------------B----------------------------o---------------------------------------------------------------------
------o-----------------X-----------------------------------------------------------------------------------o------------B----B-------------------------------------------------------------------------
--------------------------------------------------------------------------------------------------------------------------------------------------------------------------------------------------------
----------------------------------B---------------------------------------------------------------------------------------------------------------------B----------------------------------------------v
----------------------------?------------------------------o-----------------o--------------M----------------------------------------------------------------------------------B-----------------------f
--------X-------------------------------------------------------------------------------------------------------------?--B-------------------------------o---------------------------------------------f
-------------------------------------------B--------------------------------------------------o---------B---------B-----------------------------------------------------B---------------M--------------f
--------------------------------------------------o-------------------------------------------------------B-----------B---------------------------X-B---------------------------------------------X----f
---------------B-----------B---------------------------------------------------------------------------------------------------o---------------------------------------------B-------------------------f
-----oo-o---------------------------------------B------------------------------------------------------------------------------------------------------------------------------------------------------f
m---------------------B-----------------------------o--------------------------------------------------------------------------------------------B-----------------------------------------------------X
XXXXXXXXXXXXXXXXXXXXXXXXXXXXXXXXXXXXXXXXXXXXXXXXXXXXXXXXXXXXXXXXXXXXXXXXXXXXXXXXXXXXXXXXXXXXXXXXXXXXXXXXXXXXXXXX-XXXXXXXXXXXXXXXXXXXXXXXXXXXXXXXXXXXXXXXXXXXXXXXXXXXXXXXXXXXXX-XXXXXXXXXXXXXXXXXXXXXXXXX
