-X|-??-E-oM-o-T?-TEE-MBEM||X--?--?-ME-?BM-B-X?|-?E---MMBMT-?TEBoBX-?----M-M|-X--E--oo--B--o--X?---oo?B--?E-M-|MXooE----X|-o-o-o|M-T--E--X-BE--TE?|---TX-|?-----o---?B-?-TT-|--oXT-BBoEM|Mo--oE-E-EET-o-|
M-T-B--?-E?|MB?M-M?o--T-MXoT--E--|-T|?oMBET-|oBXE|-?-Xo-|X--BEo?T|-E----?-EM-?--o--XT--o--T-TT|-M-EME--MM|-B-?oXMTB----|E-T-X-M?M-M-|M----MT--o-TE---TX--|-M-E-ME---B-T-|X|B--MXTB-ETMXooMB-oE-|oEo|-XX-
TTT--M-o-?BEo-?X-?ME-MM-BMXE--o--B-XEBME|Xo-?M-EXT-|-TTo?o-EEM?TTE------|-M|-E--|---B--E--E-E-B-B-T|oo--TX-o--MBoM-----To-|Bo-|-X-X-|o--|-MM--?o-X---TM-ET-T-X-|M--?--B-E|M|--XEM-EMTM?XXTB||M-X-BM?-B?X
X?X-oE-B-XXTXEX--X?--oo?---|--B--?-EE||TT-o-oBMXMB-T-EEB??-TT?TTo--?----o-?M-T------|--E--T-|TB-?-?EXM-TTX-M-?EXMB?-----E-BMo--?--|-BT----|T--BT?B---TE-BB-?-E-MX---T---MMX|--?ooMXB|MXXTEoMEo-TTEBM-?-?
E|X-ET-?-XB-METB-?|--TE?MX|?--M--X-BE|XoEo--?BMX??-o-|-|ME-oEo-oX?-?----o-BX-?-----oE--o--T-XTo-|-BT?M-M|M-X-o?XE?T----M--|||-oBE-X-----T-MM--oBMT---M|-ME-|-?-?|-----X--MM?--??-BEEEXXEoX-?E?-oo?M?-???
|MT-B?---X-MEMEM-MoX-M|BToE?--o--T-??TTToB?-XX|BE--E-T||B|--?oBETT---------M-M--o--XM--B--X-|X?-?-MT?T-?TB-X-BBETMT----TM-TXT-BXT---oM----B---o|M?---|B-TM-M-E-|?--BE-X-ooE?---X?oMXEMB?XMEM|o-?MT|o-o|-
oBX-??-?-oT--|Bo-BoE-?B-?BTT--X--T-oTMMX?Xo-TBBoM?-E-XE?MM-T-|oM?|-E----M-XM-o--M--B|--B--B-EET-|--|EE-?-M-|--?T|?E----XM-T|?-TE|-E-oB--M-?T---Xoo---M--|B---M-ET--To-o-XBo|---?M-?XE-EM|?E|ET--|||--ET|
E?E-To-B-B??BTBM-oXB-Eo|-|?o--o--X-MMEX-B?|-EBEM|--B--|-Eo-X-|TT?E-B----?-TB-o--M--|---o--|-|?T-B-XXT|-TEX-X-?MEB?B----|--XXT-|B|-M-Bo----BT--BM?T---oo-|E-E-T-?M--EX-B-BoMM--MBMEMX|?BBBT|T?B-M-XEB-o-v
-oB-Xo-M-M?|-Mo--|-X-oBM?X?T--|--M-M|BXTT-o-EBX??E-?-oo-TB-MXXE--o-?----M-o?-X--M--MT--X----EoE---MB---E-o-B--EE?------oT-M-E-X??-E-X?--?-T|--|oXo---XM-MM-X---XX--?|-E-XX-?--EoBE-|E-BBoMoE|M-EMoM--|Bo
??--BB---||EMToT--EX-||XE-ET--?--|-EXoTXoMM-oE?MXo-M-XE-|o-???MEMo-o----?-TT----T--XB--T--E-BEE-?--BBX--BE-B-EBB||T----T---M|-|Bo-B-TE--T-oM--|-|M----M-||-X-?-|E--M|-|-E-T---oEoo?M-B||T?X-?M-EoXET-|o?
-XE-|X-|---?XX-M--E|-E?BE|ET--?--?-|oEMTo-M-oBB-BE-|-B-BB---XEEBXo-M----|-MM-o--T--|B--X--?-BTX---?-To-BoB---Xo?EMo----Mo-?|M-XET-M-XB--B-BM--MXME---|?-To-o-|-ME--ME-M-?--B--BXEoBXMX?BB?|o?o-Xo??M-E|-
To?-E|-X--XBETM|--|X-|?E|o?E--E--E-TB-?-BBo-|oTMBE-?-MXX|X-?B-|M|?-E----B-?X-X--?--MX--M--E-|TM-E-?||X-?M|-E-??o?|-----oB-oX--|?E-T-To--M-Mo---??|---E--X|-B-E-oE--T|-o-?MBX--XM|?MBM?o|?-M--T-XXXME-TTT
EoM-M|-T-|?|X?Eo-BE?--TETMBE--?--B-XoTEE-T|-|E-oMB-o-M??EE-??|-BBX-o----B--B-X-----?o--M--E-TX|-?--???-oEB-B-MEB-TE----T?-?Eo---o-?-oB--o-BE--oT-?---|E-E|-o-?--E--MB---EXB|--E?oTXMT-BTToM|MX-TBTEM-o|M
B?B-TM-|-T?-TE??-|XX-XXXT|oE--M--?-E|E?oX?E-B??oE|-M-oBoEX-?EooEoo-B----?-M?-|--?---?--T--?-EXB-T-TMMT-BX|-T-oXXoEE----o|-EE?-BEE---M|--E-X---BTM|---TT-?T-|-M-MM--oT-M-M|oE--TB|-?|TX?TB?M?|B-ETMXB-EM|
m|M-o?-B-?Moo|oo-B?--|X-TTTT--E--M-EEEoTE---oEMEBE-M-|TEEE-BBoT-ME-E----?-XM-T--?--|---B--X-oXB-M-EM|o--?B-X-M?TM-o----XX-MEM-M|B-B-TT--|-EE--?TE?---MT-T|-X-?-o---?o-T--oTB---?|E?|-?|TBB|-oX-E?|To-o?|
XXXXXXXXXXXXXXXXXXXXXXXXXXXXXXXXXXXXXXXXXXXXXXXXXXXXXXXXXXXXXXXXXXXXXXXXXXXXXXXXXXXXXXXXXXXXXXXXXXXXXXXXXXXXXXXXXXXXXXXXXXXXXXXXXXXXXXXXXXXXXXXXXXXXXXXXXXXXXXXXXXXXXXXXXXXXXXXXXXXXXXXXXXXXXXXXXXXXXXXX
