----E-------------E------M---------E-----------------------?---------------------------------M------------------------EMMo----------M----B-------------M----------M-E-------B------X---------o-------E-E
|--X--------o------M----------------MB--o-----E--X--------?----------------X----?---E---------------------------B--------M------M-M-----X---------------X--MB---M-----------------------------E--X----EB
B-o-----------------o------------------E--X-X-------------------------------o--------M-------------o-------------B-----------------------X--------M--?----------?---------------------------------X---MX
T-o-------------------------B----------M------MM-----------X-B------------o--E------oM-----?--------EM--------oM--------X-----X---------------o------------------------E--------?-----E---------o---M-TB
E----E----------B----------------------------E--------?------o-E----oE-----------------------------X----------E----B----------------------------?-----------------------Xo-----E---o--------o-BX---o--XX
oo-----E------------B-?-----B------E---------------X------M--------------------------?--------X--------------X------------?--o--------------?-?----------------X----------------M--B--o--------------oXE
X?-----B----------X--------------?o---X--X--------------------------------B--------------------------------X---------------------E--------o-o----?---------X-----------------------E---?-------------E-|
M---------------B--------------------------------E-----------------EX---B-X-------M--E--------------B--------------E--X---M--------X--------o-XB------E------------M---------------------?-----E------?v
?-------------B---E-----------------?-?X-----X--------o--------o-----------------------------X----------X---E--X-------------------------------------------?---------M?------------X------------------BT
o----?--------o------?----------------------E---------X------------------?-------------X--E?------------------?-------------o?--EX----------X---------------------------------------------------------TX
B-----M----------------X-------------------------------------M-------------------------------------------------M-------E----------------------E-------B-X--------E----------------------------E-------E?
?X--?----?----M-----B------------M-----------------E---------------------------B---------B-----B----------o------?-?-------B--X-----------------------------E----B--E--?------X------------------------o
M----------X--------E---------------------------------o--------------B--------X--E-----M--------B-B-------------B---------------------------------------?-------o-E----------M---o-E-----o-------BB--ToX
o---------------X------------------------------o-----------------o----?---------------B-----B-------E---------------M---------M-----------X-o---------------------------E------------------------E----BX
mX---------XMo-------------o--------XXE---X-M-B--X-------------X---------B---------X-??--------X------------------XX-----------X-XM-X---X----------E---B------X-----X------------?---X-X--X--?-----M--|o
X-XXXXXXXXX-XXXXXXXXXXXXXXXXXXXXXXXX--XXXX-XXXXXX-X-XXXXXXXXXXX-XXXX-XXXXXXXXXXXXXX-XXXXXXXX-XX-XXXXXXXXXXXX-XXXXX-XXXXXXXXXXXX-X-XX-XXX-XXXXXXXXXXXXXXXXXXXXX-XXXXX?XXX-XXXXXXXXXXXXXX-XXXXoXXX-XXXXXXX
