-----------------------------------------B--------------------------------------------------------------o-----------------------------------------------------------------------------------------------
------------------------------------------------------------------------------------------------------------------B------------------------------------------------------------------o--------o--B-B----
------------------------------------------------------------M-----------------------------------------------------------------o--------------------------------------------------------X----------------
------------------------------------B-----------------B-------------------------------------------------------------------------------------------------o---------------------------------o-------------
--------o--------------------B--------------------------------B--------------------------------o--------------------------------------------------------------------B----B------------------------------
-------------------------------------o------------------------------------------------------------------------------------------------------------------------------------------------------------------
---------------------------------o-------------------------------------------------------------------------------------B--------------------------------------------------------------------------------
-------------------------M--------------------------------B----B------------------------------------------------------------------B--------------------------------------------------------------------v
-------o--------------------B--X-------------------------------------------------------------------------------------------------------------o--B------B-----------------------------------------------f
--------B-----------------------------------------B----------------------------------------------------------------------B-------------------------------o---B-----------------------------------------f
------------------B-----B------------------------------------M--------------------------------o--------------------------------------------------------------------------------------------------------f
-------------------------------------------B---------------------------------------------------B--------------------------B----------------------------------------------------------------------------f
----------M-------------------o------o-----------------------------------------------------------------------------------------------------------------B-----------------------------------------------f
-------------------------------------------------------------------------------------------------------------------------------------------------------------------------------------------------------f
m--------------------------------------------------------------------------------------------------------E----------------------------------X----------------------------------------------------------X
XXXXXX-XXXXXXXXXXXXXXXXX-XXXXXXXXXXXXXXXXXXXXXXXXXXXXXXXXXXXXXXXXXXXXXXXXXXXXXXXXXXXXXXXX-XXXXXXXXXXXXXXXXXXXXXX-XXXXXXXXXXXXXXXXXXXXXXXXXXX-XXXXXXXXXXXXXXXXXXXXXXXXXXXXXXXXXXXXXXXXXXXXXXXXXXXXXXXXXXX
