----EB--B-B--M--?MXM|XB----T-B|EMo-MBooB-X-B-B--EMXE--B??---o-oo-T-ME-TX?o??Too-MEoT?ToE-B-TEEo?E-X-E||---X---?-M|BE-B-BM?-TTME-|-TT-EBM----X|-X-?oMB|X-XX|-oT|--X---M-?--?o?E?o--M-M?T---MX-M|-?T-MM|E-
--o-?BX-X-o-MB--XTBEXXB---?---|EX?-E-X-?-B-E----oo|X---MT--TT--o-T-?-oX|B?M|?M|---??-??XXE?-MET|X-M-EXX-?-M---?--TMEXo-o|X-?X?T-o--B--XET---ET-|-T|BE?M-XET--XEo-EMEM?-T--|BoTE---o-TME--E-E-EB-XM-?oE--
----TB?-X-B-?B--oE|XXM----ME-EXXoT--M--T-|-M|B---|TB--oXT--?E-Mo-T-|--o?X|MEoT?-|MT-B|--||||M|B?B-E-X-E-?-T---|-?|?oEE-TME--M?T-|-X|-BET?--BB?-E-T?XMB|-TMT-TT?E-|-X---|--M-ToT|--X--BX---B?-|--To-E|??-
--|-X-M-B-E-?E--T|oTTXM---M--|?|XT-M||?--?--oB--EMEE---XM--EM-MM-E-T-XTEMTMBBEB-TBETMoE|XMMTMEE|?-o--T?---X---?-MXoMBE-E?|-T|XB-X-M?-X-T|--B|T-X-TEMMMX-MoX-X-?--?B-|B-?--??T|MT--M-ETX--|XT-M?-?o-|oX?-
--T-XTX-?-T-BB--MM|XBT?---|T--X|M--oE?E?-T-ooX---B|---?-T--?--XT-M-o-oBT?MTMTBB-E-T|E|M?EMEo?--o--o-XoE-------X-XXXTTE-XMT-ooo?-|--X-XEEE--|XT-|-B-MBXX-X-T-|XTo-MTBE?----BB|M-X--X-BMB---MX-E|-E|-|TBM-
--?-??B-?-?-oT--TEB?BEX---T?-X|?---B|o-X--------o|TM--T?---EB-B--T-B-XMM|T|EBXX-|BET-BMMXE?-M??XB-|-T---?-?---?--|o??X---?-|TXo-B-BE--oMB--ToB---?TM?XE-MX?--E?--oBM?M-E--X?XEMM--B-oXT--BoX-?X-TM-|ToX-
--|-M?B-M-T-XT--MB??B?E-|-oX-|TToo-XEBXX-E-BB?--E?BM--TBT--|--Xo-o---ETTX?-oXTE-M--MTMBT?oTXMB|M?-TBMMo-X-?---o-?BTTMB-X|B--?TE-B-EB-E|E?--MM|-E-X||E-T-ToX--MXB-oE|XM-M--ET-T|---o-|-|--BB--E?-B|-MEXo-
--?-??--|-o-?E--To-X?Xo---TE-Bo?XX-MBo?B-o-XEE--TM-o--BXE--EE--B-o-?-?X?-B?M|o?-XT?oo|?XXo-oo--BX-E-X??---E---E--|?o-X-?o?-|MBB-M--?--|BB--|ME-|-E?T|?o--BT-TEoX-EM--T-o--EXBX-o--E-|To--B|E-EB-T--|?M-v
--B-B?E-E-B--E--?|EEBTB---M?---o---oX||X-|-oTX--BoXE--|BX--T|-EX-M-o-TTMM|T-ToB-|X-??E|EB?M-BBEET-X-?|M-X-|-----??|XXE-MMM-XM?B-?-oB---oE---?E-o-XoToEE-X-o-XBoE-|?o|X-M--TTBTX---|--EB--EMB-BB-TM-E|-Tf
--?-ooX-E-X-|----MoM-M----EX-MMMoE-MTXX?-|-XB---?E-X--TE-E-?---M-o-M-oTTM-?BBX--||o--||??E-oX?T?B-?-M?o-o-o--|X-M-XEMT-o|o-XBXB-B-oX-oME?--???---o?EMEX-?o|-?Mo|-TX-|T-?--|?BTM|----MM|--B-o-M--TE-EME?f
--M-M?E-X-M--B--?MME|?B---EM-X-MXT-MBT-X---|Mo--XM-E---B?--oT-?|-|-M-EoB|XTBMMT-BEo?|XXoTBEBT|-BT-o-MXT-X-|-----EMM|BX-M|--MoTo-E-EE-?EMB---ET-M-BMM-oM-E|B-|o?---T-M|-M--XoXEBT--M-X|---TBX-M?--E-TXMXf
--E-BX?-E-|-ME--?B---XE---E--E?X?T--|EM?-X-E?X--?XoB--?Mo--o?-|M---M-TXE?-To|EE-TX-??EooBEBo|TT-|-?-||o---B---B-E|E?-B-o-B-o-BE-M-To-Xo-o--BEo-E-ooo|||--?|-B|T?-X?TET-T--XoMoE---?-T|M--ooB-XT-XT-o-Bof
--o-TBX-T-M-M---oBET??B---ET-oEMBo-|?BTB-B-|-T--E-|?--oT?--?E-MX-o-?-E?-BMoXE|--XXEMo-BT??MT|XBo--|?X-o-o-?---?--MMMBB-X??-XE|M-T-X|-?EX?--Eo?-M-?||T-M-ooo-ToTT-???Mo-M---oTooE--?-B?---MT--||-E--|--of
--T-B?--X-|-XB--o-X-EEM---TM-B-??B---X?E-M-T-B--X|M|--?XX--B|-oM-T-E-EM?EM-||BM-oMXo|-o|B?oEM|-|o-?-XEoEB-o---X-BXoE---oEB-B|-o-M-E|-T--T--???-X-MTXoET--?--oEEM-EBBoM----o?T?MM--X-TXT--EBo-|T-M?-T-oBf
m-X-E|o-|-B-?M--?oXME?M---|T--?E|M-XEMXT-o-T?B--EM|T--E?E--|M--|-|-E-?|XoMoMXBM-TE|MXXoMX-BXX|T---E-TME-X-B---T-?-?BXX-|BE-Eo?M-M-ME-|B-E--T---|-MEX-EB-M-X-XMTT-BT|M|-E--T?|B?M--T-?-T--M|B-o|-TM-BXMXX
XXXXXXXXXXXXXXXXXXXXXXXXXXXXXXXXXXXXXXXXXXXXXXXXXXXXXXXXXXXXXXXXXXXXXXXXXXXXXXXXXXXXXXXXXXXXXXXXXXXXXXXXXXXXXXXXXXXXXXXXXXXXXXXXXXXXXXXXXXXXXXXXXXXXXXXXXXXXXXXXXXXXXXXXXXXXXXXXXXXXXXXXXXXXXXXXXXXXXXXX
