XoMo-?XX||-B|?XMB--XMX?BX-B-T-BXBXE-??oB-X-?-M----oo-?XMXo-BE-BoX---oBoT--B?oXXXM|BTMoE-?BBM?---XXM?TM-XT---?E|-?-oX-X?X?-M-MoMooXo|Bo?BEo-TE-E-B|oBo?ooXXT-ooo-oo?T-oXM?M-?ooBM?--o-MXBBMTX-MM|MXoBXM?M
o--XB?TM|MM??oXXBE-MBBX---?-M--X--Mo----XMM??---M?|o------?||X--|---Xoo?oB?-M--X?o?-XTX-----X-|T-BBE-oMXXoB-X---M-?B-Too?B?o-o-?-?T-o---BMEoEB?-MXoMXMB-BX-?BMXooToM-M---E-X?Bo?Bo?--?X-B|-?-oB-?--?MX-|
o|-o-o-Eo--Xo-B-XBB-oMB|oX--X-?X?Bo-MB--XXX-MX-M?MBXoo-T|?-|oB?XE-o--B?-B?--TXXM--MX|-BEo?XBEETo-?X-M--MB-X--?MBX--XX?X---B?-----o-MM--?-MB??-MMoMB-MBX-oBB----Bo--o-MEMoBo-oM----XT-XT-EX-B?BE-oo-M-T-|
ET??MXM--X-??--X--M-MMo--|?-X---??E--XE---??-M----B?--X?-M|o-?BEBMoT-oBX-MXM--o?E--ToMMoo-o-E--X-o-oM-?MBBXoo?B-BX-oo-E|B-o|E-TT-|oo?----M--X-XB--o?X?M-M?EBM-M-XXXT-B-BB-X-MXB?|-o|-MMM---XBBMBoE-X?o?|
Bo---XM--o?--E--TMBo---XTB-XEET--X|o-|MEo-M-o-X||XX-|X??-M-B-o?-M-TXXMM-o--EX-MBTETMo--oo--EM|-E?-o--?-----MM-o----XBE|---XE-B-|E-BoB||E-BX-T--?T----B|MoXX?--M--?EX-T-MXX?MXB?|oBTX-?B?BT--?-MMXBoB--XX
T-B|o-TB-Mo--||T?Mo-MB-oM--BT|MBo?-?|-MXB-oB--MEMoE?-----EX-X---B|XoX-X-??E-|BXEo|?Bo-Bo?o?XXoE-T-??-??BMEX?E-?????-oooo|?Mo-MXoM--B?TM|B?To-oo|--To-|B-Mo--?MTE-oB?MTB---?B-o---?MB-o?o?M-oXMo---BB?-?T
E-?M-|-?MB-BM?-??Xo--EM--?-BT?--MTMMT-BoB--?BMB--o?o-|BEToB-?--XBMXB--TMo-ME?-M-oo?-?----o?M-?-X?BX?-?oBM-BXT?B?M-ToXo??-XXXooX?-|--ToTB-Bo--XX--T?TT-??-M-?-o|--?--M-X|T--|o-MBBoXo-?Mo-?Bo--EB??o-E-?E
T-oM|oB-oMX-o-o??-EooM-|-EM|MoM?|--E|oo-B|--M?XB?M--?-|B---XB|ooX--o-|-XX-X-E-Eo-MBo?MM--X-o--BM-XB--MoBX--E?BBMMX-X-o-o--o-X-Bo--EM-?Mo--TB-?X-|Xo-oMXoME--X?-X-XEoMoo?|?o-EM-B?XoT---M-BoTT|--X?ET?o-v
B--X--?B--o-E--BT?X--Mo-??E-?-XMEEE?-XB-T?BB--o-oT-o||MMBB-?BX--|XBXX--?o-MoB|oToB-Xoo?M-B--Bo?B-XE-X--X-B?---?M--?B-oXM-Mo-??oBT-o-B-M-?X--XBEMB---XX--T-?---B?X-BM?--MX-T|-o---Bo-|EoB---|-?oBXE|oo--|
o?o|---XTBE|X--E-X|X--o?M--XM?B|MB--oM|oXB-E-?-M-XB||o--X-o-XE-?-oo--X--T---?oMB?|--?o-MMBXMB----X??E|MM-?TBX-XMM?-X-M-o?XX?-B-ooX?o-BT--o--X-X-MMXB--oo?--X|?MX-X--o-?X-|T|BXoM-?--|-MBooMX--?X?--o---o
o---X?oBX?|-XEM-M??BB-B-MX--??T-Mo|--??XMXTXBT--BXoBBMT?-BE?EoM|B-?--MTTXM?MXo--??oX---MM-X-EM-M-o-T|oM---M---o--MBB-TXMMo?-oE-X---B-E-B??EM-?|-oo-BTMo?|o-X--B?X-BoTX-MTo?---o|-|M|-o-X---?X-?BBE-|??-o
oo?--ooX?|TMT?X-M--o--MMXX?--X--MEo-X-oB-|X-TEoM-o-XooMo-?-BM??o-?XX-TM--BoMMT-M-oXooT-?-?--MM-MBTTEoXM-------BXBoMET-X--?-Booo-T-oBX?BoBM?|-ME--?-|--BE-o-|E-?-M?ooBBB?X-????T|EX-Mo?XMBMX-TX--XXo-o--T
MX?o--M-MX-X--M-B-MM----?ooM-M?-TBo-XB?B?XET?MXEX|--BBB--oB-MX?-oX--EoM-?-X-?Xo-M-B-Eo-BBMM-o--BMTMXMM-TBB-BX??BoMXoBB||o-BB?--MEooMXXM---|--|?E-?Xoo--X-oXB-BB?-MM--?--|---BXME-?-MM?--X?-|XXoXo?-?T|BX
E--|B-BoMoBXB?ooXB--|BM--o-oo-T?o-T-BM-MoBT?--|X|---XB-T--BXMXM--MMTB-X?o-|?BB|XB-T|?X--M-ToTo--?-X-BB-oXB-M?-XM-XB-BToX--?Bo?-TBM?--BEBXMXEoo?--?--o--|---o--M-o-MB-o-||-oXX?T---oB-B-MX?B??o-oX-B--B-o
mXXXXXXXXXXXXXXXXXXXXXXXXXXXXXXXXXXXXXXXXXXXXXXXXXXXXXXXXXXXXXXXXXXXXXXXXXXXXXXXXXXXXXXXXXXXXXXXXXXXXXXXXXXXXXXXXXXXXXXXXXXXXXXXXXXXXXXXXXXXXXXXXXXXXXXXXXXXXXXXXXXXXXXXXXXXXXXXXXXXXXXXXXXXXXXXXXXXXXXE
X------------------------------------------------------------------------------------------------------------------------------------------------------------------------------------------------------X
