B----------------------------------------------------------------------X-------------------------o-BMB-------------------------------------------------------------------------------------------------X
?----------------------------------------------------------------------?---------------------------T-|M------------------------------------------------------------------------------------------------E
|----------------------------------------------------------------------M---------------------------E-oT-------------------------------------------------?----------------------------------------------|
X----------------------------------------------------------------------E---------------------------M||?------------------------------------------------------------------------------------------------X
|--------------------------------------------------------------------------------------------------BBMM------------------------------------------------------------------------------------------------X
M----------------------------------------------------------------------?---------------------------|oM?------------------------------------------------------------------------------------------------E
B----------------------------------------------------------------------X--------------------------?--?|------------------------------------------------------------------------------------------------?
o------------------X---------------------------------------------------?---------------------------XT-o------------------------------------------------------------------------------------------------v
----------------------------------B------------------------------------M---------------------------TM|X------------------------------------------------------------------------------------------------?
B---------------------------------------------------------------------T---------------------------M-|||------------------------------------------------------------------------------------------------T
T--------------------------------------------------------------------------------------------------T-ET------------------------------------------------------------------------------------------------X
T----------------------------------------------------------------------o----------------------------T?T------------------------------------------------------------------------------------------------X
-----------------------------------------------------------------------E---------------------------||-E-----------------------------B----------X-------------------------------------------------------o
o----------------------------------------------------------------------?---------------------------EXB-------------------------------------------------------------------------------------------------o
m------------------X------------X----------X---------------------------B------X-------------X------XB-T---------------------------------------X--------X--------------X------------X-----------------XXX
XX-XXXXXXX--XXXXXXX-XXXXXXXXXXXX-XXXXXXXXXX-XXXXXXXXXXXX--XXXXXXXXXXXXXXXXXXXX-XXXXXXXXXXXXX-XXXXXXXXX-XXXXXXXXXXXXXXXXXXXXXXXXXXXXXXXXXXXXXXX-XXXXX-XX-XXX-XXXXXXXXXXX-XXXXXXXXXXX-XXXXXXXXXXXXXXXXX--X
