---TEBo-M|B-Xo--?-oM|-o|---T-B|EoM-ME-X-BX?B-B--E-oE--E??--oo-?--T-M-ETE??M-Xoo|-o?M?ToE?Bo--Eo?E-X-E||-|-TB--|-o|BM-|TB---TTMEo|--oT-E-T----?-X-|XM-|X-?XMToTXB-X---E-|M-?o?--o--X|-MT----X-M|-?T-TM|E-
--oB?BB-MXo-oX--X-|MX-XX-T?---|EE--EM-o-XBoE----o?|X---MT--MT-?--T-?-oXEB-?TEM|T-||--??XTE|?-EToX-M-EXX-E-|T--M-TTM-BTTo---?X?TTo-MBX-E-B?-|-E-M-|MBM?M-|EEo-X-T-EMEMT--|-|Bo-o---|o--E--E-E-EB-XM-|oEo-
---BTBX-oMB-o---o-|EX-??-BME-EXX?-----o-o|EM|B---MTB--TXT---E-|--T-|--oEXE?XMT??-ETMB|--T||M-|B?B-E-X-EME-MT--|-o|?|X?oT----M?TTT-TEX-o--|-M-?-T-oXXBB|--M|XTTTT-|-X-o-BB-M-T-X|--oo-MX----?-|--To-E|?o-
--|EX-B-MME-?|--T-MTT--M-EM--|?|MT-MM-o--??-oB--Eo?E--MXM--?M----E-T-XTEMoooXEBB-??XMoo|BM?X-EE|?-o--T?|--EM--?-XXoMBBME---T|XBM--|X|-?-ET-|-?-B-EXMBMX-Xo-XX-|X-?B-|o-BE-??T-BX--T?-TX--|-T-M?-?o-?oXM-
--TBXTX-XT--MT--M-?EB-|M-B|T--X|-M-oB-T-|T?ooX---E|---E-T--E--|--M-o-oB|?oEETBB?--?TE|??XM-?---E--o-XoEM|-EE--X-oXX-E?-X---ooo?TE-|EM-X-B--?---X-X?MTXX-E-BB|XBX-MTBEE-To-BB|-?---TX-?B----X-E|-E|-MTBT-
--????M-MB?-oM--T-T-B-oT--T?-X|?M?-B|-o-?-M-----oMoM--B?---|B-T--T-B-XM-|?-MEXX?-?To-BMMMEBB-??XB-|-T--BX-MB----T|o|oBX----|TXoB|-BMT-X-?M-M-B-M-M-M-XE-oX||-E---oBM?T-?--X?X-oM--X?-BT--B-X-?X-TM--ToT-
--|XM?B-BoT-?T--M--XB--M-|oX-|TTXE-X--T-BEBBB?--EEXM--|BT--E--T--o---ET?XoM-?TET-MT|TM-TXoTT-B|X?-TBMMoT|-T|--X-XBTo|X|X----?TE?|-oTo-?-?E-o-X-|-E-|M-T-ooXX-MTB-oE|XE-TM-ET--X---Xo-o|--B---E?-B|-|EX|-
--?E??|-TEo-BM--T-M??-M|--TE-Bo?|?-MM---Eo?XEE--TXMo---XE--TE-?--o-?-?X|-o?-To?T-E|oo|EXXoB?---TX-E-X??MT-??--E-||?TE|o?---|MBBT--TE?-o-oB-T-T-T-M-TX?o-EB|?TEoX-EM--B-M--EXB-?o--|B--o--B-E-EB-T--M?MMv
--B?B?--MoB-|E--?-BoB-XE-TM?---o-T-oM-T-B|EoTX--BToE--MBX---|-T--M-o-TT?MX-|ooB|-EB??EB|-?TM-BE|T-X-?|MM|-?E--T-|?|??B|M---XM?BT?-?-M-?-M?---B-M-?|TTEE-T-XEXB?o-|?o|--MM-TTB-ME---E-BB--E-B-BB-TM-?|-of
--?XooB-?-X-XM----E?--oo-XEX-MMMEo-M|-|-o|BXB---??oX--TE-E----E--o-M-oTTMT?-EX---|-M-|T?ME-M-?TMB-?-M?o-o-|B-||-X-XB|oXo---XBXBXB-||?-E-?--o-M-|-BBE?EX-To|??M?o-TX-|B-X?-|?B-?|--|?-?|--B-o-M--TE-MMEBf
--M-M?M-MTM-TX--?-oM|-TT-TEM-X-M-M-Mo-|-|-B|Mo--XETE---B?---T-T--|-M-EoB|M?||MT?-oEB|X?o?BXo-|-|T-o-MXT||-E?--X-oMMBMBoM---MoToMo-BEM-o-??-E-?-E-?BM-oM-M|M||o----T-M--B?-XoX-TT--T--X---T-X-M?--E-TXMTf
--EXBXE-TB|--M--?-XTX-EB-|E--E?XXB--M-M--XBE?X--??XB--XMo--T?-?----M-TX-?-MX-EEM-B-o?E|oEEoo-TTT|-?-||o-T-E?--o-B|E-ooMo---o-BEBB--XB-T-oB-E-?-B-Moo-||-T??BB||--X?TEE--B-XoM-T---|--BM--o-B-XT-XT-E-Bof
--oTTBM-??M--E--o-Bo?-E---ET-oEMoT-|B-B-MBo|-T--EMo?--MT?--TE-|--o-?-E?MBXoM-|-E-MEoo-XTX?ET-XBM--|?X-oTX-Eo----EMMEoMXX---XE|MT|-?T|-?-oX-E-o-?-M||X-M-ToX?ToM--???M|-XT--oT-|E--o|-?---M---||-E-----|f
--TMB?X-ME|-|X--o-MME-BB--TM-B-?|X--?-o-|MXT-B--Xo||--EXX--o|-T--T-E-EMMEMB--BME-?XE|-T|B?|?-|-Bo-?-XEo?--XM--B-BXo--T|o---B|-oM|-|B?-E-EM-o-|-X-?TXMET-|?|-oE-|-EBBoo-ME-o?T-EM--Bo-BT--E-o-|T-M?-E-oMf
m-XME|?-MBB-BB--?-EBE-ET-E|T--?E-X-Xo-?-oo-T?B--E?|T---?E--EM-|--|-E-?|To??BTBMX-EM|XXMMo--o-|TM--E-TME?T-|T--E---?-||E|---Eo?M|?-EBo-o-BE-|-o-?-|TXMEB-M--BXM?T-BT|MB-X--T?|-BM--|B--T--M-B-o|-TM-BXMMX
XXXXXXXXXXXXXXXXXXXXXXXXXXXXXXXXXXXXXXXXXXXXXXXXXXXXXXXXXXXXXXXXXXXXXXXXXXXXXXXXXXXXXXXXXXXXXXXXXXXXXXXXXXXXXXXXXXXXXXXXXXXXXXXXXXXXXXXXXXXXXXXXXXXXXXXXXXXXXXXXXXXXXXXXXXXXXXXXXXXXXXXXXXXXXXXXXXXXXXXX
